tanggal,meninggal,sembuh,positif,positif_aktif,meninggal harian,sembuh harian,self-isolation harian,dirawat harian,positif harian,positif aktif harian,rasio_kematian,rasio_sembuh,rasio_sembuh_meninggal
2020-01-29,0,0,0,0,0,0,0,0,0,0,0.0,0.0,0.0
2020-03-01,0,0,0,0,0,0,0,0,0,0,0.0,0.0,0.0
2020-03-02,0,0,0,0,0,0,0,0,0,0,0.0,0.0,0.0
2020-03-03,1,0,3,2,1,0,0,2,3,2,0.3333333333333333,0.0,0.0
2020-03-04,1,0,3,2,0,0,0,0,0,0,0.3333333333333333,0.0,0.0
2020-03-05,3,0,7,4,2,0,0,2,4,2,0.42857142857142855,0.0,0.0
2020-03-06,3,0,7,4,0,0,0,0,0,0,0.42857142857142855,0.0,0.0
2020-03-07,3,0,7,4,0,0,0,0,0,0,0.42857142857142855,0.0,0.0
2020-03-08,3,0,7,4,0,0,0,0,0,0,0.42857142857142855,0.0,0.0
2020-03-09,3,0,34,31,0,0,0,27,27,27,0.08823529411764706,0.0,0.0
2020-03-11,3,0,36,33,0,0,0,2,2,2,0.08333333333333333,0.0,0.0
2020-03-12,5,0,62,57,2,0,0,24,26,24,0.08064516129032258,0.0,0.0
2020-03-13,7,0,72,65,2,0,0,8,10,8,0.09722222222222222,0.0,0.0
2020-03-14,9,0,79,70,2,0,0,5,7,5,0.11392405063291139,0.0,0.0
2020-03-15,11,0,95,84,2,0,0,14,16,14,0.11578947368421053,0.0,0.0
2020-03-16,12,0,97,85,1,0,7,-6,2,1,0.12371134020618557,0.0,0.0
2020-03-17,12,0,122,110,0,0,20,5,25,25,0.09836065573770492,0.0,0.0
2020-03-18,15,12,160,133,3,12,15,8,38,23,0.09375,0.075,0.8
2020-03-19,19,13,210,178,4,1,15,30,50,45,0.09047619047619047,0.06190476190476191,0.6842105263157895
2020-03-20,20,13,224,191,1,0,9,4,14,13,0.08928571428571429,0.05803571428571429,0.65
2020-03-21,23,17,268,228,3,4,5,32,44,37,0.08582089552238806,0.06343283582089553,0.7391304347826086
2020-03-22,29,21,304,254,6,4,6,20,36,26,0.09539473684210527,0.06907894736842106,0.7241379310344828
2020-03-23,29,22,355,304,0,1,2,48,51,50,0.08169014084507042,0.061971830985915494,0.7586206896551724
2020-03-24,34,23,426,369,5,1,30,35,71,65,0.07981220657276995,0.0539906103286385,0.6764705882352942
2020-03-25,43,27,472,402,9,4,3,30,46,33,0.09110169491525423,0.057203389830508475,0.627906976744186
2020-03-26,49,29,515,437,6,2,1,34,43,35,0.09514563106796116,0.05631067961165048,0.5918367346938775
2020-03-27,57,31,566,478,8,2,19,22,51,41,0.10070671378091872,0.054770318021201414,0.543859649122807
2020-03-28,62,43,603,498,5,12,2,18,37,20,0.10281923714759536,0.07131011608623548,0.6935483870967742
2020-03-29,67,48,701,586,5,5,17,71,98,88,0.09557774607703282,0.06847360912981455,0.7164179104477612
2020-03-30,78,49,727,600,11,1,0,14,26,14,0.10729023383768914,0.06740027510316368,0.6282051282051282
2020-03-31,84,49,741,608,6,0,6,2,14,8,0.11336032388663968,0.06612685560053981,0.5833333333333334
2020-04-01,90,51,816,675,6,2,19,48,75,67,0.11029411764705882,0.0625,0.5666666666666667
2020-04-02,95,54,909,760,5,3,19,66,93,85,0.10451045104510451,0.0594059405940594,0.5684210526315789
2020-04-03,98,56,990,836,3,2,14,62,81,76,0.09898989898989899,0.05656565656565657,0.5714285714285714
2020-04-04,99,58,1071,914,1,2,14,64,81,78,0.09243697478991597,0.05415499533146592,0.5858585858585859
2020-04-05,123,64,1151,964,24,6,56,-6,80,50,0.10686359687228497,0.05560382276281494,0.5203252032520326
2020-04-06,131,68,1299,1100,8,4,38,98,148,136,0.100846805234796,0.05234795996920708,0.5190839694656488
2020-04-07,141,69,1443,1233,10,1,21,112,144,133,0.09771309771309772,0.04781704781704782,0.48936170212765956
2020-04-08,144,75,1552,1333,3,6,19,81,109,100,0.09278350515463918,0.04832474226804124,0.5208333333333334
2020-04-09,155,82,1719,1482,11,7,48,101,167,149,0.09016870273414776,0.0477021524141943,0.5290322580645161
2020-04-10,156,82,1810,1572,1,0,28,62,91,90,0.0861878453038674,0.045303867403314914,0.5256410256410257
2020-04-11,168,142,1903,1593,12,60,8,13,93,21,0.0882816605359958,0.07461902259590121,0.8452380952380952
2020-04-12,195,142,2082,1745,27,0,27,125,179,152,0.0936599423631124,0.06820365033621517,0.7282051282051282
2020-04-13,209,142,2242,1891,14,0,53,93,160,146,0.09322033898305085,0.06333630686886708,0.6794258373205742
2020-04-14,243,163,2349,1943,34,21,37,15,107,52,0.10344827586206896,0.06939123031077055,0.6707818930041153
2020-04-15,246,164,2447,2037,3,1,55,39,98,94,0.10053126277073968,0.06702084184715978,0.6666666666666666
2020-04-16,248,202,2670,2220,2,38,6,177,223,183,0.09288389513108614,0.07565543071161049,0.8145161290322581
2020-04-17,250,203,2823,2370,2,1,24,126,153,150,0.08855827134254339,0.07190931633014523,0.812
2020-04-18,257,206,2902,2439,7,3,27,42,79,69,0.08855961405926947,0.0709855272226051,0.8015564202334631
2020-04-19,292,207,3033,2534,35,1,25,70,131,95,0.09627431585888559,0.06824925816023739,0.708904109589041
2020-04-20,297,237,3112,2578,5,30,57,-13,79,44,0.09543701799485861,0.07615681233933162,0.797979797979798
2020-04-21,305,286,3279,2688,8,49,1,109,167,110,0.09301616346447088,0.08722171393717597,0.9377049180327869
2020-04-22,308,291,3399,2800,3,5,62,50,120,112,0.09061488673139159,0.08561341571050309,0.9448051948051948
2020-04-23,316,292,3506,2898,8,1,73,25,107,98,0.0901312036508842,0.08328579577866514,0.9240506329113924
2020-04-24,331,327,3605,2947,15,35,71,-22,99,49,0.09181692094313454,0.09070735090152567,0.9879154078549849
2020-04-25,350,334,3681,2997,19,7,91,-41,76,50,0.09508285791904374,0.09073621298560174,0.9542857142857143
2020-04-26,357,338,3746,3051,7,4,49,5,65,54,0.09530165509877202,0.09022957821676456,0.9467787114845938
2020-04-27,375,338,3832,3119,18,0,70,-2,86,68,0.09786012526096033,0.08820459290187892,0.9013333333333333
2020-04-28,379,341,3950,3230,4,3,37,74,118,111,0.0959493670886076,0.08632911392405063,0.899736147757256
2020-04-29,381,412,4033,3240,2,71,32,-22,83,10,0.09447061740639723,0.10215720307463427,1.0813648293963254
2020-04-30,381,412,4138,3345,0,0,34,71,105,105,0.09207346544224262,0.09956500724987917,1.0813648293963254
2020-05-01,393,427,4283,3463,12,15,40,78,145,118,0.09175811347186552,0.09969647443380808,1.0865139949109415
2020-05-02,400,562,4355,3393,7,135,-8,-62,72,-70,0.09184845005740529,0.12904707233065443,1.405
2020-05-03,410,622,4417,3385,10,60,19,-27,62,-8,0.09282318315598823,0.14081956078786506,1.5170731707317073
2020-05-04,412,650,4472,3410,2,28,7,18,55,25,0.09212880143112702,0.14534883720930233,1.5776699029126213
2020-05-05,414,711,4641,3516,2,61,40,66,169,106,0.0892049127343245,0.15319974143503556,1.7173913043478262
2020-05-06,420,713,4709,3576,6,2,11,49,68,60,0.08919091102144829,0.15141218942450627,1.6976190476190476
2020-05-07,430,718,4775,3627,10,5,50,1,66,51,0.09005235602094241,0.15036649214659686,1.669767441860465
2020-05-08,431,763,4901,3707,1,45,-5,85,126,80,0.08794123648235054,0.15568251377269945,1.7703016241299303
2020-05-09,437,767,4958,3754,6,4,16,31,57,47,0.0881403791851553,0.15469947559499797,1.7551487414187643
2020-05-10,444,803,5140,3893,7,36,91,48,182,139,0.08638132295719844,0.15622568093385214,1.8085585585585586
2020-05-11,453,836,5195,3906,9,33,115,-102,55,13,0.08719923002887392,0.16092396535129933,1.8454746136865343
2020-05-12,457,1262,5303,3584,4,426,93,-415,108,-322,0.08617763530077314,0.23797850273430135,2.761487964989059
2020-05-13,461,1277,5437,3699,4,15,125,-10,134,115,0.08478940592238367,0.23487217215376127,2.770065075921909
2020-05-14,466,1279,5617,3872,5,2,129,44,180,173,0.08296243546377069,0.22770162008189426,2.744635193133047
2020-05-15,474,1286,5679,3919,8,7,24,23,62,47,0.08346539883782356,0.22644831836590948,2.7130801687763713
2020-05-16,475,1292,5795,4028,1,6,101,8,116,109,0.08196721311475409,0.22295081967213115,2.72
2020-05-17,478,1295,5922,4149,3,3,97,24,127,121,0.08071597433299561,0.2186761229314421,2.709205020920502
2020-05-18,483,1301,5996,4212,5,6,49,14,74,63,0.08055370246831221,0.21697798532354903,2.6935817805383024
2020-05-19,487,1417,6053,4149,4,116,-53,-10,57,-63,0.08045597224516769,0.234098793986453,2.909650924024641
2020-05-20,493,1425,6150,4232,6,8,50,33,97,83,0.08016260162601627,0.23170731707317074,2.890466531440162
2020-05-21,498,1536,6220,4186,5,111,-32,-14,70,-46,0.08006430868167203,0.24694533762057877,3.0843373493975905
2020-05-22,501,1558,6316,4257,3,22,51,20,96,71,0.07932235592146929,0.246675110829639,3.1097804391217565
2020-05-23,504,1587,6443,4352,3,29,64,31,127,95,0.07822442961353407,0.24631382896166382,3.1488095238095237
2020-05-24,505,1594,6561,4462,1,7,85,25,118,110,0.07696997408931565,0.2429507696997409,3.1564356435643566
2020-05-25,506,1648,6628,4474,1,54,-1,13,67,12,0.07634278817139409,0.24864212432106217,3.2569169960474307
2020-05-26,508,1678,6689,4503,2,30,29,0,61,29,0.07594558229929735,0.2508596202720885,3.3031496062992125
2020-05-27,510,1698,6826,4618,2,20,125,-10,137,115,0.07471432757105186,0.24875476120714912,3.3294117647058825
2020-05-28,514,1719,6929,4696,4,21,57,21,103,78,0.0741809784961755,0.24808774714966084,3.3443579766536966
2020-05-29,517,1807,7053,4729,3,88,81,-48,124,33,0.07330214093293634,0.2562030341698568,3.495164410058027
2020-05-30,519,2003,7151,4629,2,196,59,-159,98,-100,0.07257726192140959,0.2801006852188505,3.859344894026975
2020-05-31,520,2102,7272,4650,1,99,46,-25,121,21,0.07150715071507151,0.28905390539053905,4.042307692307692
2020-06-01,521,2246,7383,4616,1,144,-5,-29,111,-34,0.0705675199783286,0.3042123797914127,4.310940499040307
2020-06-02,525,2405,7459,4529,4,159,-36,-51,76,-87,0.07038477007641775,0.3224292800643518,4.580952380952381
2020-06-03,529,2534,7539,4476,4,129,-9,-44,80,-53,0.07016845735508688,0.3361188486536676,4.790170132325142
2020-06-04,530,2607,7600,4463,1,73,16,-29,61,-13,0.06973684210526315,0.3430263157894737,4.918867924528302
2020-06-05,532,2751,7684,4401,2,144,-25,-37,84,-62,0.06923477355543987,0.35801665799062987,5.171052631578948
2020-06-06,535,2840,7786,4411,3,89,8,2,102,10,0.06871307474955048,0.36475725661443614,5.308411214953271
2020-06-07,537,3170,7946,4239,2,330,18,-190,160,-172,0.06758117291719104,0.39894286433425624,5.9031657355679705
2020-06-08,538,3205,8037,4294,1,35,52,3,91,55,0.06694040064700758,0.39878063954211773,5.9572490706319705
2020-06-09,547,3369,8276,4360,9,164,72,-6,239,66,0.06609473175447075,0.4070807153214113,6.159049360146252
2020-06-10,551,3517,8423,4355,4,148,10,-15,147,-5,0.06541612252166687,0.41754719221180103,6.382940108892922
2020-06-11,555,3664,8552,4333,4,147,-41,19,129,-22,0.06489710009354537,0.4284377923292797,6.601801801801802
2020-06-12,561,3780,8628,4287,6,116,-24,-22,76,-46,0.06502086230876217,0.4381084840055633,6.737967914438503
2020-06-13,564,3840,8748,4344,3,60,62,-5,120,57,0.0644718792866941,0.438957475994513,6.808510638297872
2020-06-14,571,4091,8863,4201,7,251,-92,-51,115,-143,0.06442513821505133,0.46158185715897554,7.1646234676007
2020-06-15,580,4198,8968,4190,9,107,-33,22,105,-11,0.06467439785905442,0.4681088314005352,7.2379310344827585
2020-06-16,583,4329,9092,4180,3,131,-36,26,124,-10,0.0641223053233612,0.4761328640563132,7.425385934819897
2020-06-17,588,4444,9209,4177,5,115,11,-14,117,-3,0.06385058095341514,0.482571397545879,7.557823129251701
2020-06-18,594,4592,9385,4199,6,148,47,-25,176,22,0.06329248801278636,0.48929142248268515,7.730639730639731
2020-06-19,599,4682,9525,4244,5,90,40,5,140,45,0.06288713910761155,0.4915485564304462,7.816360601001669
2020-06-20,603,4821,9703,4279,4,139,77,-42,178,35,0.06214572812532206,0.49685664227558485,7.9950248756218905
2020-06-21,615,5054,9830,4161,12,233,-65,-53,127,-118,0.06256358087487283,0.5141403865717192,8.21788617886179
2020-06-22,618,5128,9957,4211,3,74,27,23,127,50,0.06206688761675203,0.5150145626192628,8.297734627831716
2020-06-23,619,5228,10123,4276,1,100,56,9,166,65,0.06114788106292601,0.5164476933715302,8.445880452342488
2020-06-24,628,5322,10277,4327,9,94,21,30,154,51,0.06110732704096526,0.5178554052739126,8.47452229299363
2020-06-25,631,5435,10472,4406,3,113,90,-11,195,79,0.0602559205500382,0.5190030557677616,8.613312202852615
2020-06-26,632,5542,10640,4466,1,107,68,-8,168,60,0.059398496240601506,0.5208646616541354,8.768987341772151
2020-06-27,632,5610,10853,4611,0,68,120,25,213,145,0.058232746705979915,0.5169077674375748,8.876582278481013
2020-06-28,635,5865,10985,4485,3,255,-93,-33,132,-126,0.05780609922621757,0.5339098771051434,9.236220472440944
2020-06-29,636,6118,11080,4326,1,253,136,-295,95,-159,0.05740072202166065,0.5521660649819494,9.619496855345911
2020-06-30,641,6512,11276,4123,5,394,-127,-76,196,-203,0.056846399432422846,0.5775097552323519,10.159126365054602
2020-07-01,644,6680,11482,4158,3,168,97,-62,206,35,0.05608778958369622,0.5817801776693956,10.372670807453416
2020-07-02,646,6871,11677,4160,2,191,87,-85,195,2,0.055322428706003256,0.5884216836516228,10.636222910216718
2020-07-03,648,7109,11824,4067,2,238,-25,-68,147,-93,0.05480378890392422,0.6012347767253045,10.970679012345679
2020-07-04,650,7377,12039,4012,2,268,35,-90,215,-55,0.053991195282000165,0.6127585347620235,11.349230769230768
2020-07-05,658,7663,12295,3974,8,286,24,-62,256,-38,0.05351769011793412,0.6232614884099227,11.645896656534955
2020-07-06,658,8033,12526,3835,0,370,-50,-89,231,-139,0.05253073606897653,0.641306083346639,12.208206686930092
2020-07-07,664,8277,12725,3784,6,244,39,-90,199,-51,0.05218074656188605,0.6504518664047151,12.465361445783133
2020-07-08,667,8429,13069,3973,3,152,177,12,344,189,0.05103680465223047,0.6449613589410055,12.637181409295353
2020-07-09,677,8647,13359,4035,10,218,28,34,290,62,0.050677445916610525,0.6472789879481997,12.772525849335302
2020-07-10,684,8825,13598,4089,7,178,29,25,239,54,0.05030151492866598,0.6489924988968966,12.902046783625732
2020-07-11,690,9040,13957,4227,6,215,119,19,359,138,0.049437558214516016,0.6477036612452532,13.101449275362318
2020-07-12,702,9200,14361,4459,12,160,173,59,404,232,0.04888238980572383,0.6406239119838452,13.105413105413106
2020-07-13,710,9408,14639,4521,8,208,19,43,278,62,0.04850058064075415,0.6426668488284719,13.250704225352113
2020-07-14,714,9528,14914,4672,4,120,129,22,275,151,0.04787448035402977,0.6388628134638594,13.344537815126051
2020-07-15,720,9721,15173,4732,6,193,-12,72,259,60,0.04745271205430699,0.6406775192776643,13.501388888888888
2020-07-16,722,9857,15466,4887,2,136,69,86,293,155,0.04668304668304668,0.6373335057545584,13.652354570637119
2020-07-17,731,9994,15707,4982,9,137,46,49,241,95,0.046539759342968105,0.6362768192525625,13.671682626538988
2020-07-18,740,10117,16038,5181,9,123,133,66,331,199,0.04614041651078688,0.6308143159995012,13.671621621621622
2020-07-19,748,10444,16351,5159,8,327,-53,31,313,-22,0.04574643752675677,0.6387376918842884,13.962566844919786
2020-07-20,749,10602,16712,5361,1,158,99,103,361,202,0.04481809478219244,0.6343944471038775,14.154873164218959
2020-07-21,758,10864,17153,5531,9,262,123,47,441,170,0.044190520608639886,0.6333585961639363,14.33245382585752
2020-07-22,766,11187,17529,5576,8,323,-75,120,376,45,0.04369901306406526,0.6381995550231045,14.60443864229765
2020-07-23,767,11302,17945,5876,1,115,292,8,416,300,0.042741710782947896,0.6298133184731123,14.735332464146023
2020-07-24,768,11585,18230,5877,1,283,-98,99,285,1,0.04212835984640702,0.6354909489851892,15.084635416666666
2020-07-25,769,11715,18623,6139,1,130,152,110,393,262,0.041293024754336036,0.629060838747785,15.23407022106632
2020-07-26,779,11889,19001,6333,10,174,113,81,378,194,0.040997842218830585,0.6257039103205094,15.261874197689345
2020-07-27,782,11996,19473,6695,3,107,151,211,472,362,0.040158167719406355,0.6160324551943717,15.340153452685422
2020-07-28,795,12373,19885,6717,13,377,-124,146,412,22,0.03997988433492582,0.622227809906965,15.563522012578616
2020-07-29,820,12613,20470,7037,25,240,224,96,585,320,0.040058622374206154,0.6161700048851978,15.38170731707317
2020-07-30,821,12801,20769,7147,1,188,5,105,299,110,0.03953006885261688,0.6163512927921422,15.59196102314251
2020-07-31,836,13208,21201,7157,15,407,-124,134,432,10,0.03943210225932739,0.6229894816282251,15.799043062200957
2020-08-01,852,13887,21575,6836,16,679,-291,-30,374,-321,0.039490150637311705,0.6436616454229432,16.299295774647888
2020-08-02,852,14027,21954,7075,0,140,233,6,379,239,0.03880841760043728,0.6389268470438189,16.46361502347418
2020-08-03,867,14165,22443,7411,15,138,168,168,489,336,0.03863119903756183,0.6311544802388273,16.337946943483274
2020-08-04,880,14381,22909,7648,13,216,132,105,466,237,0.038412850844646206,0.627744554541883,16.342045454545456
2020-08-05,895,14760,23266,7611,15,379,-88,51,357,-37,0.03846815094988395,0.6344021318662426,16.491620111731844
2020-08-06,908,15006,23863,7949,13,246,269,69,597,338,0.03805053849055023,0.6288396261995558,16.526431718061673
2020-08-07,922,15201,24521,8398,14,195,406,43,658,449,0.03760042412625912,0.6199176216304392,16.48698481561822
2020-08-08,934,15710,25242,8598,12,509,307,-107,721,200,0.03700182235955946,0.6223754060692497,16.820128479657388
2020-08-09,939,16268,25714,8507,5,558,-19,-72,472,-91,0.03651707241191569,0.6326514739052657,17.324813631522897
2020-08-10,940,16446,26193,8807,1,178,161,139,479,300,0.035887450845645784,0.6278776772420113,17.495744680851065
2020-08-11,953,16927,26664,8784,13,481,-16,-7,471,-23,0.03574107410741074,0.6348259825982598,17.76180482686254
2020-08-12,968,17349,27242,8925,15,422,-28,169,578,141,0.03553336759415608,0.6368475148667498,17.922520661157026
2020-08-13,981,17838,27863,9044,13,489,122,-3,621,119,0.03520798191149553,0.6402038545741665,18.18348623853211
2020-08-14,985,18528,28438,8925,4,690,1,-120,575,-119,0.03463675363949645,0.6515226105914621,18.81015228426396
2020-08-15,991,18974,29036,9071,6,446,126,20,598,146,0.03413004546080727,0.6534646645543464,19.146316851664984
2020-08-16,995,19708,29554,8851,4,734,-173,-47,518,-220,0.03366718549096569,0.6668471272924139,19.807035175879395
2020-08-17,1011,19916,30092,9165,16,208,230,84,538,314,0.033596969294164565,0.661837033098498,19.699307616221564
2020-08-18,1028,20505,30597,9064,17,589,88,-189,505,-101,0.03359806516978789,0.6701637415432885,19.94649805447471
2020-08-19,1046,21069,31162,9047,18,564,-114,97,565,-17,0.033566523329696424,0.6761119311982543,20.14244741873805
2020-08-20,1061,21795,31757,8901,15,726,-131,-15,595,-146,0.0334099568599049,0.686305381490695,20.541941564561736
2020-08-21,1076,22228,32398,9094,15,433,161,32,641,193,0.03321192666213964,0.6860917340576579,20.65799256505576
2020-08-22,1091,22877,32999,9031,15,649,-249,186,601,-63,0.033061607927512955,0.6932634322252189,20.96883593033914
2020-08-23,1107,23567,33636,8962,16,690,-229,160,637,-69,0.03291116660720656,0.700648115114758,21.28906955736224
2020-08-24,1112,25463,34295,7720,5,1896,-950,-292,659,-1242,0.03242455168391894,0.7424697477766439,22.89838129496403
2020-08-25,1129,25986,34931,7816,17,523,40,56,636,96,0.03232086112622026,0.7439237353640034,23.016829052258636
2020-08-26,1144,26750,35642,7748,15,764,-152,84,711,-68,0.03209696425565344,0.75051905055833,23.382867132867133
2020-08-27,1147,28288,36462,7027,3,1538,-479,-242,820,-721,0.03145740771213867,0.775821403104602,24.662598081952922
2020-08-28,1154,29169,37278,6955,7,881,-371,299,816,-72,0.030956596383926175,0.7824722356349589,25.276429809358753
2020-08-29,1172,29768,38166,7226,18,599,286,-15,888,271,0.03070795996436619,0.7799612220300791,25.399317406143346
2020-08-30,1186,30134,39280,7960,14,366,531,203,1114,734,0.03019348268839104,0.7671588594704685,25.408094435075885
2020-08-31,1202,30538,40309,8569,16,404,336,273,1029,609,0.02981964325584857,0.7575975588578233,25.405990016638935
2020-09-01,1219,31267,41250,8764,17,729,142,53,941,195,0.02955151515151515,0.7579878787878788,25.649712879409353
2020-09-02,1237,31741,42303,9325,18,474,334,227,1053,561,0.0292414249580408,0.7503250360494528,25.659660468876314
2020-09-03,1253,32424,43709,10032,16,683,566,141,1406,707,0.028666864947722435,0.7418151868036331,25.877094972067038
2020-09-04,1260,33260,44604,10084,7,836,-66,118,895,52,0.02824858757062147,0.745673033808627,26.396825396825395
2020-09-05,1277,33991,45446,10178,17,731,244,-150,842,94,0.028099282665141046,0.7479426132112837,26.61785434612373
2020-09-06,1289,34738,46691,10664,12,747,81,405,1245,486,0.027607033475402113,0.7439977725900067,26.949573312645462
2020-09-07,1318,35431,47796,11047,29,693,124,259,1105,383,0.027575529332998578,0.7412963427901916,26.882397572078908
2020-09-08,1330,36451,48811,11030,12,1020,-108,91,1015,-17,0.027247956403269755,0.7467783901169819,27.406766917293233
2020-09-09,1347,37245,49837,11245,17,794,93,122,1026,215,0.027028111643959307,0.747336316391436,27.65033407572383
2020-09-10,1365,38226,51287,11696,18,981,277,174,1450,451,0.026614931659094898,0.7453350751652466,28.004395604395604
2020-09-11,1382,39115,52321,11824,17,889,175,-47,1034,128,0.02641386823646337,0.7475965673438963,28.30318379160637
2020-09-12,1404,40183,53761,12174,22,1068,347,3,1440,350,0.0261155856475884,0.7474377336731087,28.62037037037037
2020-09-13,1410,41014,54864,12440,6,831,301,-35,1103,266,0.025699912510936132,0.7475575969670458,29.087943262411347
2020-09-14,1440,42325,55926,12161,30,1311,-261,-18,1062,-279,0.025748310267138717,0.756803633372671,29.39236111111111
2020-09-15,1468,43306,56953,12179,28,981,181,-163,1027,18,0.025775639562446228,0.7603813670921638,29.5
2020-09-16,1498,44251,58458,12709,30,945,196,334,1505,530,0.025625235211604914,0.7569708166546922,29.540053404539385
2020-09-17,1513,45207,59472,12752,15,956,106,-63,1014,43,0.025440543449018024,0.760139225181598,29.879048248512888
2020-09-18,1535,46235,60875,13105,22,1028,437,-84,1403,353,0.025215605749486652,0.7595071868583162,30.120521172638437
2020-09-19,1546,47260,61807,13001,11,1025,246,-350,932,-104,0.02501334800265342,0.7646383095765852,30.56921086675291
2020-09-20,1561,49209,62886,12116,15,1949,-399,-486,1079,-885,0.024822695035460994,0.7825112107623319,31.524023062139655
2020-09-21,1592,49630,64196,12974,31,421,928,-70,1310,858,0.024799052900492242,0.7731011277961244,31.17462311557789
2020-09-22,1624,50473,65318,13221,32,843,155,92,1122,247,0.024862978045867908,0.7727272727272727,31.079433497536947
2020-09-23,1650,51578,66505,13277,26,1105,231,-175,1187,56,0.02481016464927449,0.7755507104728968,31.259393939393938
2020-09-24,1664,52742,67638,13232,14,1164,103,-148,1133,-45,0.024601555338714925,0.7797687690351578,31.69591346153846
2020-09-25,1677,54352,68927,12898,13,1610,313,-647,1289,-334,0.024330088354345903,0.7885444020485441,32.41025641025641
2020-09-26,1679,55350,70184,13155,2,998,567,-310,1257,257,0.023922831414567424,0.7886412857631369,32.96605122096486
2020-09-27,1692,56413,71370,13265,13,1063,321,-211,1186,110,0.023707440100882726,0.7904301527252346,33.34101654846336
2020-09-28,1704,57741,72177,12732,12,1328,-441,-92,807,-533,0.023608628787563906,0.7999916871025395,33.88556338028169
2020-09-29,1718,58865,73309,12726,14,1124,185,-191,1132,-6,0.023435048902590405,0.8029709858271153,34.26367869615832
2020-09-30,1731,60320,74368,12317,13,1455,-306,-103,1059,-409,0.023276140275387262,0.8111015490533563,34.84690930098209
2020-10-01,1737,61444,75521,12340,6,1124,192,-169,1153,23,0.023000225102951497,0.8136015148104501,35.37363270005757
2020-10-02,1740,62279,76619,12600,3,835,-49,309,1098,260,0.02270977172763936,0.8128401571411791,35.79252873563218
2020-10-03,1743,63286,77784,12755,3,1007,156,-1,1165,155,0.022408207343412527,0.8136120538928314,36.308663224325876
2020-10-04,1761,64319,79214,13134,18,1033,439,-60,1430,379,0.022230918776983865,0.8119650566818997,36.524134014764336
2020-10-05,1772,65295,80036,12969,11,976,-179,14,822,-165,0.022140036983357488,0.8158203808286271,36.848194130925506
2020-10-06,1806,66315,81043,12922,34,1020,-125,78,1007,-47,0.022284466270991943,0.8182693138210579,36.71926910299003
2020-10-07,1819,67310,82383,13254,13,995,20,312,1340,332,0.022079798016581092,0.8170374955998203,37.00384826827928
2020-10-08,1838,68352,83392,13202,19,1042,-90,38,1009,-52,0.02204048349961627,0.819646968534152,37.18824809575626
2020-10-09,1860,69203,84364,13301,22,851,29,70,972,99,0.022047318761557064,0.8202906452989427,37.20591397849462
2020-10-10,1877,70487,85617,13253,17,1284,-48,0,1253,-48,0.021923216183701834,0.8232827592650992,37.55301012253596
2020-10-11,1901,71549,87006,13556,24,1062,165,138,1389,303,0.021849067880376067,0.822345585361929,37.637559179379274
2020-10-12,1922,72633,88174,13619,21,1084,-49,112,1168,63,0.021797808877900515,0.8237462290471114,37.79032258064516
2020-10-13,1944,73733,89228,13551,22,1100,94,-162,1054,-68,0.02178688304119783,0.8263437485990944,37.928497942386834
2020-10-14,1961,74924,90266,13381,17,1191,-86,-84,1038,-170,0.0217246803890723,0.8300356723461768,38.207037225905154
2020-10-15,1984,75974,91337,13379,23,1050,-186,184,1071,-2,0.021721755695939215,0.8317987234089143,38.29334677419355
2020-10-16,2008,76956,92382,13418,24,982,-138,177,1045,39,0.021735835985365114,0.8330194193674092,38.32470119521912
2020-10-17,2032,78062,93356,13262,24,1106,93,-249,974,-156,0.021766142508247998,0.836175500235657,38.41633858267716
2020-10-18,2051,79136,94327,13140,19,1074,191,-313,971,-122,0.02174350928154187,0.838953852025401,38.584105314480745
2020-10-19,2064,80261,95253,12928,13,1125,-457,245,926,-212,0.021668608862712987,0.8426086317491313,38.88614341085271
2020-10-20,2086,81107,96217,13024,22,846,-33,129,964,96,0.021680160470602908,0.8429591444339358,38.88159156279961
2020-10-21,2105,82178,97217,12934,19,1071,-19,-71,1000,-90,0.021652591624921568,0.8453048335167718,39.03942992874109
2020-10-22,2120,83338,98206,12748,15,1160,-293,107,989,-186,0.02158727572653402,0.8486039549518359,39.31037735849057
2020-10-23,2138,84430,99158,12590,18,1092,-376,218,952,-158,0.021561548236148368,0.8514693721131931,39.49017773620206
2020-10-24,2153,85586,100220,12481,15,1156,-47,-62,1062,-109,0.021482737976451807,0.8539812412692077,39.7519739897817
2020-10-25,2164,86815,100991,12012,11,1229,-406,-63,771,-469,0.021427651968987337,0.8596310562327336,40.117837338262476
2020-10-26,2185,87977,101897,11735,21,1162,-191,-86,906,-277,0.0214432220771956,0.8633914639292619,40.264073226544625
2020-10-27,2195,89060,102678,11423,10,1083,-217,-95,781,-312,0.02137751027483979,0.8673717836342741,40.57403189066059
2020-10-28,2211,90157,103522,11154,16,1097,-305,36,844,-269,0.021357779022816405,0.8708970073993934,40.77657168701945
2020-10-29,2225,91235,104235,10775,14,1078,-487,108,713,-379,0.021345997025950976,0.8752818151292752,41.00449438202247
2020-10-30,2239,92312,104847,10296,14,1077,-494,15,612,-479,0.021354926702719202,0.8804448386696806,41.22912014292095
2020-10-31,2255,94434,105597,8908,16,2122,-933,-455,750,-1388,0.021354773336363722,0.8942867695104975,41.87760532150776
2020-11-01,2273,94819,106205,9113,18,385,411,-206,608,205,0.021402005555294007,0.8927922414198954,41.7153541575011
2020-11-02,2291,95876,107229,9062,18,1057,377,-428,1024,-51,0.021365488813660485,0.8941237911385912,41.84897424705369
2020-11-03,2300,96902,107846,8644,9,1026,-468,50,617,-418,0.021326706600152068,0.8985219665077981,42.13130434782609
2020-11-04,2315,97833,108620,8472,15,931,-179,7,774,-172,0.021312833732277665,0.9006904805744799,42.26047516198704
2020-11-05,2331,98806,109411,8274,16,973,-405,207,791,-198,0.02130498761550484,0.9030719031907212,42.387816387816386
2020-11-06,2348,99830,110083,7905,17,1024,-210,-159,672,-369,0.021329360573385536,0.9068611865592325,42.517035775127766
2020-11-07,2359,100816,111201,8026,11,986,109,12,1118,121,0.02121383800505391,0.9066105520633807,42.736752861381945
2020-11-08,2366,101791,112027,7870,7,975,179,-335,826,-156,0.021119908593464076,0.9086291697537201,43.02240067624683
2020-11-09,2377,102844,112743,7522,11,1053,-288,-60,716,-348,0.021083348855361308,0.9121985400423973,43.26630206142196
2020-11-10,2391,104144,113756,7221,14,1300,-326,25,1013,-301,0.02101867154259995,0.9155033580646296,43.556670849017145
2020-11-11,2403,105117,114343,6823,12,973,-563,165,587,-398,0.02101571587241895,0.9193129443866263,43.74406991260924
2020-11-12,2414,106189,115174,6571,11,1072,-283,31,831,-252,0.020959591574487298,0.9219876013683644,43.988815244407625
2020-11-13,2428,107147,116207,6632,14,958,150,-89,1033,61,0.020893749946216664,0.9220356777130465,44.12973640856672
2020-11-14,2441,108209,117462,6812,13,1062,-318,498,1255,180,0.020781188809998127,0.9212255878496876,44.32978287587054
2020-11-15,2448,109181,118627,6998,7,972,242,-56,1165,186,0.02063611150918425,0.9203722592664402,44.600081699346404
2020-11-16,2455,110221,119633,6957,7,1040,-532,491,1006,-41,0.020521093678165722,0.9213260555197981,44.89653767820774
2020-11-17,2459,111096,120671,7116,4,875,-65,224,1038,159,0.020377721242054843,0.920652020783784,45.17934119560797
2020-11-18,2470,111948,121818,7400,11,852,264,20,1147,284,0.020276149665895023,0.9189774910111806,45.323076923076925
2020-11-19,2484,112833,123003,7686,14,885,14,272,1185,286,0.020194629399282946,0.9173190897782981,45.42391304347826
2020-11-20,2501,113739,124243,8003,17,906,-17,334,1240,317,0.020129906715066443,0.9154560015453587,45.477409036385446
2020-11-21,2515,114863,125822,8444,14,1124,707,-266,1579,441,0.019988555260606253,0.9129007645721734,45.67117296222664
2020-11-22,2531,115939,127164,8694,16,1076,206,44,1342,250,0.019903431788871065,0.9117281620584442,45.807585934413275
2020-11-23,2548,117003,128173,8622,17,1064,63,-135,1009,-72,0.019879381773072333,0.9128521607514843,45.919544740973315
2020-11-24,2567,118062,129188,8559,19,1059,-74,11,1015,-63,0.01987026658822801,0.9138774499179491,45.99220880405142
2020-11-25,2584,119099,130461,8778,17,1037,482,-263,1273,219,0.01980668552287657,0.9129088386567633,46.09094427244582
2020-11-26,2597,120287,131525,8641,13,1188,-124,-13,1064,-137,0.019745295571184186,0.9145561680288918,46.31767423950712
2020-11-27,2614,121082,132961,9265,17,795,777,-153,1436,624,0.019659900271508185,0.910658012499906,46.32058148431523
2020-11-28,2632,122328,134331,9371,18,1246,268,-162,1370,106,0.01959339244105977,0.9106460906268843,46.47720364741642
2020-11-29,2652,123163,135762,9947,20,835,687,-111,1431,576,0.019534184823441023,0.9071978904258924,46.441553544494724
2020-11-30,2671,124078,136861,10112,19,915,215,-50,1099,165,0.019516151423707266,0.9065986657996069,46.45376263571696
2020-12-01,2689,125102,137919,10128,18,1024,114,-98,1058,16,0.019496951108984258,0.9070686417389917,46.523614726664185
2020-12-02,2710,126163,139085,10212,21,1061,265,-181,1166,84,0.01948448790308085,0.9070927849875975,46.55461254612546
2020-12-03,2734,127136,140238,10368,24,973,-47,203,1153,156,0.019495429198933243,0.9065731114248634,46.50182882223848
2020-12-04,2757,128051,141270,10462,23,915,-82,176,1032,94,0.01951582076874071,0.9064274085085298,46.44577439245557
2020-12-05,2779,129067,142630,10784,22,1016,550,-228,1360,322,0.019483979527448642,0.9049078034074178,46.443684778697374
2020-12-06,2799,130136,143961,11026,20,1069,196,46,1331,242,0.019442765749057036,0.9039670466306847,46.493747767059666
2020-12-07,2823,131071,145427,11533,24,935,654,-147,1466,507,0.019411801109835175,0.9012838056206894,46.42968473255402
2020-12-08,2842,132248,146601,11511,19,1177,177,-199,1174,-22,0.019385952346846202,0.9020948015361423,46.53342716396904
2020-12-09,2860,133318,147838,11660,18,1070,53,96,1237,149,0.019345499803839337,0.9017843856112772,46.61468531468532
2020-12-10,2880,134366,149018,11772,20,1048,-312,424,1180,112,0.01932652431249916,0.9016763075601605,46.65486111111111
2020-12-11,2902,135545,150250,11803,22,1179,-313,344,1232,31,0.019314475873544092,0.9021297836938436,46.70744314266023
2020-12-12,2922,136489,151201,11790,20,944,-256,243,951,-13,0.01932526901277108,0.9026990562231731,46.71081451060917
2020-12-13,2941,137605,152499,11953,19,1116,-143,306,1298,163,0.019285372363097464,0.9023337857953166,46.788507310438625
2020-12-14,2963,138988,154065,12114,22,1383,315,-154,1566,161,0.0192321422776101,0.9021387076883134,46.90786365170435
2020-12-15,2990,140225,155122,11907,27,1237,-351,144,1057,-207,0.01927515117133611,0.9039659107025438,46.89799331103679
2020-12-16,3010,141365,156343,11968,20,1140,-380,441,1221,61,0.019252540887663663,0.9041978214566689,46.96511627906977
2020-12-17,3027,142741,158033,12265,17,1376,-412,709,1690,297,0.019154227281643708,0.9032354002012238,47.15592996366039
2020-12-18,3048,143959,159620,12613,21,1218,-178,526,1587,348,0.019095351459716827,0.9018857286054379,47.23064304461942
2020-12-19,3068,145066,161519,13385,20,1107,439,333,1899,772,0.018994669357784533,0.8981358230301079,47.28357235984355
2020-12-20,3087,146958,163111,13066,19,1892,-55,-264,1592,-319,0.01892576221100968,0.9009692785894269,47.605442176870746
2020-12-21,3097,148308,164577,13172,10,1350,309,-203,1466,106,0.018817939323234716,0.9011465757669662,47.88763319341298
2020-12-22,3115,149691,165888,13082,18,1383,254,-344,1311,-90,0.018777729552469136,0.9023618344907407,48.05489566613162
2020-12-23,3130,151122,167842,13590,15,1431,23,485,1954,508,0.01864849084257814,0.9003825025917231,48.281789137380194
2020-12-24,3146,152491,169775,14138,16,1369,190,358,1933,548,0.01853040789279929,0.8981946694154027,48.471392244119514
2020-12-25,3167,154242,171871,14462,21,1751,-113,437,2096,324,0.018426610655666167,0.8974288856177016,48.70287338174929
2020-12-26,3182,156798,173929,13949,15,2556,719,-1232,2058,-513,0.018294821450131952,0.901505786844057,49.27655562539284
2020-12-27,3204,158615,175926,14107,22,1817,216,-58,1997,158,0.01821220285801985,0.9016006730102429,49.50530586766542
2020-12-28,3226,159878,177604,14500,22,1263,264,129,1678,393,0.018164005315195603,0.9001936893313214,49.55920644761314
2020-12-29,3246,161337,179660,15077,20,1459,99,478,2056,577,0.018067460759211843,0.8980129132806413,49.70332717190388
2020-12-30,3266,162911,181713,15536,20,1574,-136,595,2053,459,0.017973397610517684,0.8965291421087099,49.880894060012245
2020-12-31,3287,164881,183735,15567,21,1970,-136,167,2022,31,0.017889895773804666,0.897384820529567,50.16154548220262
2021-01-01,3308,166512,185691,15871,21,1631,336,-32,1956,304,0.017814541361724584,0.8967155112525648,50.33615477629988
2021-01-02,3334,168781,187586,15471,26,2269,790,-1190,1895,-400,0.01777318136747945,0.8997526467860075,50.624175164967006
2021-01-03,3345,170510,189243,15388,11,1729,106,-189,1657,-83,0.017675686815364373,0.9010108696226544,50.9745889387145
2021-01-04,3369,173036,191075,14670,24,2526,-607,-111,1832,-718,0.017631819965981944,0.9055920450085045,51.361234787770854
2021-01-05,3392,174131,192899,15376,23,1095,526,180,1824,706,0.017584331696898377,0.9027055609412179,51.33579009433962
2021-01-06,3410,175441,195301,16450,18,1310,1299,-225,2402,1074,0.01746022805822807,0.8983108125406424,51.44897360703812
2021-01-07,3435,176882,197699,17382,25,1441,585,347,2398,932,0.017374898203835122,0.8947035645096839,51.49403202328966
2021-01-08,3463,179562,200658,17633,28,2680,616,-365,2959,251,0.017258220454704022,0.8948658912178932,51.85157377995957
2021-01-09,3485,181613,203411,18313,22,2051,-321,1001,2753,680,0.017132800094390176,0.8928376538141989,52.11276901004304
2021-01-10,3517,184576,206122,18029,32,2963,90,-374,2711,-284,0.01706271043362669,0.8954696733002785,52.48109183963605
2021-01-11,3551,187086,208583,17946,34,2510,375,-458,2461,-83,0.01702439796148296,0.8969379096091245,52.68544072092369
2021-01-12,3589,188675,211252,18988,38,1589,1050,-8,2669,1042,0.016989188268040065,0.8931276390282695,52.57035385901365
2021-01-13,3634,191635,214728,19459,45,2960,418,53,3476,471,0.016923736075407026,0.8924546402891099,52.73390203632361
2021-01-14,3675,193719,217893,20499,41,2084,843,197,3165,1040,0.016866076468725476,0.8890556374000083,52.712653061224486
2021-01-15,3710,195924,220434,20800,35,2205,-299,600,2541,301,0.016830434506473594,0.8888102561310869,52.80970350404313
2021-01-16,3745,198136,223970,22089,35,2212,1971,-682,3536,1289,0.016720989418225654,0.8846541947582266,52.906809078771694
2021-01-17,3779,201907,227365,21679,34,3771,-783,373,3395,-410,0.01662085193411475,0.8880302597145558,53.42868483725854
2021-01-18,3815,204711,229726,21200,36,2804,-322,-157,2361,-479,0.016606740203546834,0.8911094085998102,53.65950196592399
2021-01-19,3836,209238,232289,19215,21,4527,-1815,-170,2563,-1985,0.016513911549836627,0.9007658563255255,54.5458811261731
2021-01-20,3868,210983,236075,21224,32,1745,1785,224,3786,2009,0.01638462353065763,0.8937117441491051,54.54576008273009
2021-01-21,3900,213570,239226,21756,32,2587,577,-45,3151,532,0.016302575806977502,0.8927541320759449,54.761538461538464
2021-01-22,3940,215719,243018,23359,40,2149,786,817,3792,1603,0.016212790822079024,0.8876667571949403,54.7510152284264
2021-01-23,3980,219287,246303,23036,40,3568,905,-1228,3285,-323,0.016158958680974247,0.8903139628831155,55.097236180904524
2021-01-24,4024,221567,249815,24224,44,2280,897,291,3512,1188,0.016107919860696915,0.8869243239997598,55.06138170974155
2021-01-25,4063,224071,252266,24132,39,2504,315,-407,2451,-92,0.016106015079321034,0.888233055584185,55.14915087373862
2021-01-26,4108,227010,254580,23462,45,2939,-437,-233,2314,-670,0.016136381491083353,0.8917039830308744,55.26046738072055
2021-01-27,4134,229981,256416,22301,26,2971,-904,-257,1836,-1161,0.016122238861849495,0.8969058093098714,55.63159167876149
2021-01-28,4185,232701,259305,22419,51,2720,-55,173,2889,118,0.01613929542430728,0.8974026725284896,55.603584229390684
2021-01-29,4224,235140,262753,23389,39,2439,908,62,3448,970,0.01607593443271818,0.8949089068440703,55.66761363636363
2021-01-30,4254,238395,266244,23595,30,3255,1158,-952,3491,206,0.01597782485239104,0.89540045972867,56.040197461212976
2021-01-31,4267,242069,269718,23382,13,3674,-1267,1054,3474,-213,0.015820227051957972,0.897489229491543,56.73048980548395
2021-02-01,4337,244202,273332,24793,70,2133,552,859,3614,1411,0.0158671505714662,0.8934263093966313,56.30666359234494
2021-02-02,4379,248515,276694,23800,42,4313,-899,-94,3362,-993,0.01582614729629121,0.8981582542447614,56.751541447819136
2021-02-03,4420,249810,280261,26031,41,1295,2938,-707,3567,2231,0.01577101344817866,0.8913477080293013,56.51809954751131
2021-02-04,4461,254155,283893,25277,41,4345,-1444,690,3632,-754,0.01571366676881783,0.8952492664489791,56.97265187177763
2021-02-05,4502,256702,287233,26029,41,2547,772,-20,3340,752,0.015673686519306625,0.893706503082863,57.01954686805864
2021-02-06,4541,261027,289612,24044,39,4325,-1866,-119,2379,-1985,0.015679598911647306,0.9012989793240611,57.48227262717463
2021-02-07,4587,265369,293825,23869,46,4342,-1367,1192,4213,-175,0.015611333276610228,0.903153237471284,57.852408981905384
2021-02-08,4631,268785,296969,23553,44,3416,-192,-124,3144,-316,0.015594220272149618,0.9050944711400853,58.04038004750594
2021-02-09,4681,271573,300406,24152,50,2788,408,191,3437,599,0.015582245361277737,0.9040198930780344,58.0160222174749
2021-02-10,4725,274817,303715,24173,44,3244,-1498,1519,3309,21,0.015557348171805804,0.9048515878372817,58.16232804232804
2021-02-11,4748,278822,306229,22659,23,4005,-2557,1043,2514,-1514,0.015504736651329561,0.9105016180701371,58.72409435551811
2021-02-12,4798,284579,310039,20662,50,5757,-3345,1348,3810,-1997,0.01547547244056393,0.917881298804344,59.3120050020842
2021-02-13,4850,289189,313057,19018,52,4610,-1130,-514,3018,-1644,0.015492386370533162,0.9237582932181679,59.62659793814433
2021-02-14,4895,293538,315553,17120,45,4349,-627,-1271,2496,-1898,0.01551244957265499,0.9302335899199183,59.96690500510725
2021-02-15,4940,295623,317432,16869,45,2085,-136,-115,1879,-251,0.01556238816502432,0.9312955215605232,59.84271255060729
2021-02-16,4987,297695,319293,16611,47,2072,161,-419,1861,-258,0.015618882969560873,0.9323568008067825,59.69420493282534
2021-02-17,5026,299795,320738,15917,39,2100,-575,-119,1445,-694,0.01567011080695147,0.9347037145582999,59.64882610425786
2021-02-18,5044,302451,321111,13616,18,2656,-1400,-901,373,-2301,0.015707963912790283,0.9418892532488765,59.96252973830293
2021-02-19,5081,304995,323031,12955,37,2544,256,-917,1920,-661,0.015729140546882497,0.9441663493596589,60.02656957291872
2021-02-20,5121,307759,325903,13023,40,2764,-158,226,2872,68,0.0157132643762101,0.944326993000985,60.09744190587776
2021-02-21,5172,310412,328623,13039,51,2653,-28,44,2720,16,0.015738399320802256,0.9445839153072061,60.01778808971385
2021-02-22,5206,312748,331094,13140,34,2336,391,-290,2471,101,0.015723631355445886,0.9445897539671513,60.074529389166344
2021-02-23,5248,314563,331876,12065,42,1815,-402,-673,782,-1075,0.015813135026335138,0.9478329255505068,59.939596036585364
2021-02-24,5301,317003,332658,10354,53,2440,-1118,-593,782,-1711,0.01593528488718143,0.9529396557425344,59.80060365968685
2021-02-25,5346,319326,334239,9567,45,2323,-509,-278,1581,-787,0.015994542827138664,0.955382226490625,59.731762065095396
2021-02-26,5385,321038,335900,9477,39,1712,61,-151,1661,-90,0.016031557011015184,0.9557546888955046,59.61708449396472
2021-02-27,5439,322285,337637,9913,54,1247,325,111,1737,436,0.01610901648812186,0.9545310496183771,59.25445854017283
2021-02-28,5478,323892,339735,10365,39,1607,55,397,2098,452,0.016124332200097135,0.9533665945516359,59.125958378970424
2021-03-01,5528,326509,341793,9756,50,2617,-49,-560,2058,-609,0.0161735319330706,0.9552828758927187,59.06458031837916
2021-03-02,5568,328526,342371,8277,40,2017,-819,-660,578,-1479,0.016263059663347654,0.9595614114513203,59.00251436781609
2021-03-03,5613,331016,343808,7179,45,2490,-1330,232,1437,-1098,0.0163259726358898,0.9627931868950111,58.97309816497417
2021-03-04,5657,332758,345816,7401,44,1742,198,24,2008,222,0.016358410252851226,0.9622400351632082,58.82234399858582
2021-03-05,5702,334100,346975,7173,45,1342,86,-314,1159,-228,0.016433460623964263,0.9628935802291231,58.593475973342684
2021-03-06,5748,335617,348591,7226,46,1517,202,-149,1616,53,0.016489238104253984,0.9627815979184775,58.38848295059151
2021-03-07,5790,337426,350425,7209,42,1809,-34,17,1834,-17,0.016522793750445887,0.9629050438752943,58.277374784110535
2021-03-08,5838,338931,352208,7439,48,1505,300,-70,1783,230,0.016575432698859766,0.9623035251896607,58.05601233299075
2021-03-09,5883,340587,353075,6605,45,1656,-638,-196,867,-834,0.01666218225589464,0.9646307441761666,57.8934217236104
2021-03-10,5923,341398,354115,6794,40,811,-165,354,1040,189,0.0167262047639891,0.9640879375344168,57.63937193989533
2021-03-11,5943,342306,355869,7620,20,908,562,264,1754,826,0.016699965436719692,0.96188766090893,57.59818273599193
2021-03-12,5969,343351,357742,8422,26,1045,417,385,1873,802,0.016685208893560163,0.9597726853430685,57.52236555536941
2021-03-13,5991,345202,358776,7583,22,1851,-444,-395,1034,-839,0.01669844136731554,0.9621658081922982,57.620096811884494
2021-03-14,6026,347210,359980,6744,35,2008,-783,-56,1204,-839,0.016739818878826602,0.9645258069892771,57.618652505808164
2021-03-15,6038,349002,361535,6495,12,1792,42,-291,1555,-249,0.01670101096712628,0.965333923409905,57.80092745942365
2021-03-16,6062,350561,362370,5747,24,1559,-489,-259,835,-748,0.016728757899384605,0.967411761459282,57.82926426921808
2021-03-17,6077,351680,363700,5943,15,1119,-89,285,1330,196,0.016708825955457796,0.9669507836128678,57.870659865065
2021-03-18,6100,352827,365419,6492,23,1147,366,183,1719,549,0.016693165927332734,0.9655409269906601,57.84049180327869
2021-03-19,6120,354036,367007,6851,20,1209,210,149,1588,359,0.01667543125880433,0.9646573498598119,57.84901960784314
2021-03-20,6143,355221,368944,7580,23,1185,411,318,1937,729,0.016650223340127498,0.9628046532807147,57.825329643496666
2021-03-21,6160,357100,370582,7322,17,1879,-35,-223,1638,-258,0.01662250190241296,0.9636193878817644,57.97077922077922
2021-03-22,6179,358826,372056,7051,19,1726,-84,-187,1474,-271,0.01660771496763928,0.9644408368632679,58.07185628742515
2021-03-23,6206,360479,372871,6186,27,1653,-668,-197,815,-865,0.0166438258808006,0.9667659860917046,58.08556235900741
2021-03-24,6224,362248,373761,5289,18,1769,-457,-440,890,-897,0.016652352706676192,0.9691968932018055,58.20179948586118
2021-03-25,6241,362975,375487,6271,17,727,572,410,1726,982,0.016621081422259626,0.9666779409140662,58.15975004005768
2021-03-26,6260,363599,376868,7009,19,624,407,331,1381,738,0.01661059044546101,0.9647913858433191,58.08290734824281
2021-03-27,6281,364251,378222,7690,21,652,303,378,1354,681,0.016606649005081672,0.9630613766518077,57.99251711510906
2021-03-28,6304,365592,379692,7796,23,1341,34,72,1470,106,0.016602930796540353,0.9628646376536771,57.993654822335024
2021-03-29,6324,366615,380706,7767,20,1023,68,-97,1014,-29,0.016611243321618258,0.9629871869631684,57.97201138519924
2021-03-30,6327,367819,381090,6944,3,1204,-615,-208,384,-823,0.01660237739116744,0.9651762050959091,58.13481902955587
2021-03-31,6341,369007,382055,6707,14,1188,-391,154,965,-237,0.016597086806873357,0.9658478491316695,58.19381800977764
2021-04-01,6344,369929,383392,7119,3,922,419,-7,1337,412,0.0165470328019364,0.9648845046323345,58.31163303909206
2021-04-02,6351,371254,384632,7027,7,1325,-14,-78,1240,-92,0.016511886686495142,0.9652187025520498,58.45599118249095
2021-04-03,6356,372494,385730,6880,5,1240,-116,-31,1098,-147,0.016477847198817827,0.9656858424286417,58.60509754562618
2021-04-04,6360,373565,386466,6541,4,1071,-168,-171,736,-339,0.01645681638229495,0.9666180207314485,58.736635220125784
2021-04-05,6372,374542,386989,6075,12,977,-378,-88,523,-466,0.016465584293093603,0.9678362950884909,58.779347143753924
2021-04-06,6379,375080,387476,6017,7,538,-66,8,487,-58,0.01646295512496258,0.9680083411617751,58.79918482520771
2021-04-07,6391,375651,388338,6296,12,571,109,170,862,279,0.016457312959329243,0.9673300063346878,58.77812548896886
2021-04-08,6410,376270,389577,6897,19,619,430,171,1239,601,0.016453743419144354,0.9658424393637202,58.70046801872075
2021-04-09,6424,376959,390590,7207,14,689,262,48,1013,310,0.016446913643462454,0.9651015130955733,58.679794520547944
2021-04-10,6435,377797,391567,7335,11,838,210,-82,977,128,0.016433969154704048,0.9648336044661577,58.70971250971251
2021-04-11,6450,379210,392598,6938,15,1413,-99,-298,1031,-397,0.016429018996530802,0.965898960259604,58.7922480620155
2021-04-12,6459,380560,393290,6271,9,1350,-293,-374,692,-667,0.016422995753769484,0.9676320272572402,58.91933735872426
2021-04-13,6482,381449,394118,6187,23,889,2,-86,828,-84,0.016446850943118558,0.9678548049061448,58.84742363468065
2021-04-14,6489,382091,394779,6199,7,642,12,0,661,12,0.016437044523644875,0.9678604991653558,58.882878717830174
2021-04-15,6504,382617,396109,6988,15,526,583,206,1330,789,0.016419722854062898,0.9659386683968302,58.8279520295203
2021-04-16,6513,383655,397088,6920,9,1038,-314,246,979,-68,0.016401905874768315,0.9661712265291321,58.906034085674804
2021-04-17,6520,384652,398125,6953,7,997,-95,128,1037,33,0.016376766091051806,0.9661588697017268,58.995705521472395
2021-04-18,6536,385615,399075,6924,16,963,-199,170,950,-29,0.016377873833239368,0.9662720040092715,58.99862301101591
2021-04-19,6558,386606,400048,6884,22,991,-95,55,973,-40,0.01639303283605967,0.9663990321161461,58.951814577615124
2021-04-20,6569,387507,400508,6432,11,901,-273,-179,460,-452,0.016401669879253348,0.9675387258182109,58.99025726899072
2021-04-21,6587,388083,401110,6440,18,576,9,-1,602,8,0.016421929146618136,0.9675226247164119,58.916502201305605
2021-04-22,6596,388735,402376,7045,9,652,543,62,1266,605,0.016392627790921925,0.9660988726961847,58.934960582171016
2021-04-23,6612,389445,403260,7203,16,710,87,71,884,158,0.01639636958785895,0.9657417051034072,58.8997277676951
2021-04-24,6623,390334,404167,7210,11,889,-21,28,907,7,0.016386790608832486,0.9657740488461453,58.93613166238865
2021-04-25,6645,391301,405063,7117,22,967,-164,71,896,-93,0.01640485554098992,0.9660250380804961,58.88653122648608
2021-04-26,6660,392595,405812,6557,15,1294,-247,-313,749,-560,0.016411540319162567,0.967430731471716,58.9481981981982
2021-04-27,6679,393205,406205,6321,19,610,-153,-83,393,-236,0.016442436700680692,0.9679964549919375,58.87183710136248
2021-04-28,6690,393814,406844,6340,11,609,-49,68,639,19,0.01644364916282408,0.9679729822733038,58.866068759342305
2021-04-29,6710,394403,407831,6718,20,589,358,20,987,378,0.016452893477935715,0.9670745970757495,58.77839046199702
2021-04-30,6733,394939,408620,6948,23,536,113,117,789,230,0.016477411776222407,0.9665190152219666,58.657210753007575
2021-05-01,6747,395644,409546,7155,14,705,112,95,926,207,0.016474339878792613,0.9660550951541463,58.639988142878316
2021-05-02,6767,396594,410400,7039,20,950,-83,-33,854,-116,0.01648879142300195,0.966359649122807,58.60706369144377
2021-05-03,6788,397349,411157,7020,21,755,33,-52,757,-19,0.016509508533236697,0.9664167215929681,58.53697701826753
2021-05-04,6807,397955,411573,6811,19,606,-236,27,416,-209,0.01653898579352873,0.9669123096024278,58.46261201704128
2021-05-05,6830,398610,412418,6978,23,655,-7,174,845,167,0.01656086785736801,0.9665194050696139,58.36163982430454
2021-05-06,6850,399224,413323,7249,20,614,166,105,905,271,0.016572994970035542,0.9658886633456158,58.28087591240876
2021-05-07,6872,399821,414106,7413,22,597,79,85,783,164,0.01659478491014378,0.9655040013909482,58.18116996507567
2021-05-08,6896,400403,414838,7539,24,582,84,42,732,126,0.01662335658739074,0.965203284173581,58.06308004640371
2021-05-09,6911,401114,415647,7622,15,711,79,4,809,83,0.016627089814193294,0.9650352342251959,58.03993633338157
2021-05-10,6933,401744,416341,7664,22,630,75,-33,694,42,0.01665221537153439,0.9649397969452924,57.94663204961777
2021-05-11,6952,402374,416747,7421,19,630,-233,-10,406,-243,0.016681583790645164,0.9655114493925571,57.87888377445339
2021-05-12,6973,403039,417403,7391,21,665,-88,58,656,-30,0.016705677726322043,0.9655872142749333,57.79994263588126
2021-05-13,6973,403630,418188,7585,0,591,228,-34,785,194,0.01667431872746229,0.9651879059179125,57.88469812132511
2021-05-14,7003,404187,418820,7630,30,557,-128,173,632,45,0.01672078697292393,0.9650613628766535,57.71626445808939
2021-05-15,7066,404715,419047,7266,63,528,-214,-150,227,-364,0.016862070364422128,0.96579858583882,57.27639399943391
2021-05-16,7082,404980,419208,7146,16,265,-99,-21,161,-120,0.016893761569435697,0.966059808018931,57.18441118328156
2021-05-17,7107,405229,419629,7293,25,249,-31,178,421,147,0.016936389048421343,0.9656839732239669,57.0182918249613
2021-05-18,7130,405357,419920,7433,23,128,90,50,291,140,0.016979424652314726,0.9653195846827968,56.852314165497894
2021-05-19,7149,405535,420459,7775,19,178,118,224,539,342,0.017002846888757285,0.9645054571313731,56.72611554063506
2021-05-20,7169,405714,421354,8471,20,179,431,265,895,696,0.017014197088433953,0.962881567518049,56.59283024131678
2021-05-21,7184,405918,422210,9108,15,204,345,292,856,637,0.017015229388219134,0.9614125672058929,56.503062360801785
2021-05-22,7196,406300,423142,9646,12,382,244,294,932,538,0.0170061114235883,0.9601977586720297,56.46192329071707
2021-05-23,7207,406669,424009,10133,11,369,358,129,867,487,0.016997280718097967,0.9591046416467575,56.42694602469821
2021-05-24,7225,406987,424828,10616,18,318,335,148,819,483,0.01700688278550378,0.9580041805154086,56.33038062283737
2021-05-25,7239,407493,425212,10480,14,506,-62,-74,384,-136,0.017024448980743723,0.958329021758558,56.29133858267716
2021-05-26,7250,408019,425829,10560,11,526,-24,104,617,80,0.01702561356788758,0.9581756996352996,56.27848275862069
2021-05-27,7271,408585,426769,10913,21,566,287,66,940,353,0.017037319955291973,0.9573914693897635,56.19378352358685
2021-05-28,7288,409497,427462,10677,17,912,-119,-117,693,-236,0.017049468724705353,0.9579728724424628,56.18784302963776
2021-05-29,7296,410508,428269,10465,8,1011,-157,-55,807,-212,0.017036021752683476,0.9585284015420215,56.264802631578945
2021-05-30,7309,411495,429333,10529,13,987,96,-32,1064,64,0.017024081540435977,0.9584518310961422,56.29976741004241
2021-05-31,7327,412074,430059,10658,18,579,141,-12,726,129,0.017037197221776545,0.958180156676177,56.24048041490378
2021-06-01,7349,412593,430578,10636,22,519,-27,5,519,-22,0.01706775543571664,0.9582305644970249,56.14274050891278
2021-06-02,7361,413179,431179,10639,12,586,-36,39,601,3,0.017071796168180733,0.95825399660002,56.13082461622062
2021-06-03,7381,413680,431893,10832,20,501,224,-31,714,193,0.017089881058502916,0.9578298328521184,56.046606150928056
2021-06-04,7402,414496,432799,10901,21,816,12,57,906,69,0.017102627316606556,0.9577101610678398,55.9978384220481
2021-06-05,7423,415317,434116,11376,21,821,342,133,1317,475,0.01709911636521114,0.9566959061633297,55.95002020746329
2021-06-06,7438,416181,435135,11516,15,864,210,-70,1019,140,0.017093545681225366,0.956441104484815,55.95334767410594
2021-06-07,7457,416994,436332,11881,19,813,295,70,1197,365,0.01709019737264285,0.9556805368389208,55.91980689285236
2021-06-08,7478,417997,437087,11612,21,1003,-204,-65,755,-269,0.017108722062198142,0.956324484599176,55.89689756619417
2021-06-09,7499,419109,438458,11850,21,1112,63,175,1371,238,0.017103120481323182,0.9558703456203331,55.8886518202427
2021-06-10,7523,420211,440554,12820,24,1102,871,99,2096,970,0.017076226750863684,0.9538240488112695,55.85683902698391
2021-06-11,7543,421396,442847,13908,20,1185,759,329,2293,1088,0.01703297075513665,0.951561148658566,55.86583587432056
2021-06-12,7557,422121,445302,15624,14,725,1105,611,2455,1716,0.016970505409811768,0.9479431936079334,55.858277094084954
2021-06-13,7571,423056,448071,17444,14,935,1179,641,2769,1820,0.016896875718357136,0.9441717942022582,55.87848368775591
2021-06-14,7609,424088,450793,19096,38,1032,1206,446,2722,1652,0.016879144086088295,0.9407599496886597,55.735050597976084
2021-06-15,7634,425417,452295,19244,25,1329,-138,286,1502,148,0.01687836478404581,0.9405741827789386,55.72661776264082
2021-06-16,7665,426695,454671,20311,31,1278,453,614,2376,1067,0.016858343725463028,0.9384697946427197,55.667971298108284
2021-06-17,7713,428764,458815,22338,48,2069,1499,528,4144,2027,0.016810697121933678,0.9345030131970402,55.58978348243226
2021-06-18,7777,431264,463552,24511,64,2500,1897,276,4737,2173,0.016776974320033135,0.9303465414883335,55.453773948823454
2021-06-19,7836,433499,468447,27112,59,2235,1836,765,4895,2601,0.01672761272886794,0.9253960426686477,55.321465033180196
2021-06-20,7905,435982,474029,30142,69,2483,2318,712,5582,3030,0.01667619491634478,0.9197369781173725,55.152688172043014
2021-06-21,7976,439007,479043,32060,71,3025,1612,306,5014,1918,0.016649862329686477,0.916425039088349,55.04099799398195
2021-06-22,8014,442059,482264,32191,38,3052,450,-319,3221,131,0.016617454340361295,0.9166327986331139,55.16084352383329
2021-06-23,8057,443195,486957,35705,43,1136,1701,1813,4693,3514,0.016545608749848548,0.9101316954063706,55.00744694054859
2021-06-24,8107,445718,494462,40637,50,2523,3535,1397,7505,4932,0.016395597639454598,0.9014201293527107,54.979400518070804
2021-06-25,8177,448288,501396,44931,70,2570,2922,1372,6934,4294,0.016308466760803837,0.8940797293955277,54.82304023480494
2021-06-26,8220,451013,510667,51434,43,2725,4504,1999,9271,6503,0.016096595237209375,0.8831841493576048,54.867761557177616
2021-06-27,8269,454497,520061,57295,49,3484,4635,1226,9394,5861,0.01590005787782587,0.8739301735757921,54.96396178498004
2021-06-28,8348,457935,528409,62126,79,3438,3788,1043,8348,4831,0.0157983683093967,0.8666298265169594,54.85565404887398
2021-06-29,8426,461439,535788,65923,78,3504,3252,545,7379,3797,0.01572636938490597,0.8612342941611234,54.76370757180157
2021-06-30,8486,464943,543468,70039,60,3504,2325,1791,7680,4116,0.01561453480241707,0.8555112720528164,54.78941786471836
2021-07-01,8528,468461,551009,74020,42,3518,2007,1974,7541,3981,0.015477061173229476,0.8501875649944012,54.932106003752345
2021-07-02,8547,473467,560408,78394,19,5006,3178,1196,9399,4374,0.015251388274257326,0.8448612439508358,55.3956943956944
2021-07-03,8577,479150,570110,82383,30,5683,1927,2062,9702,3989,0.015044465103225694,0.8404518426268615,55.86452139442696
2021-07-04,8652,484949,580595,86994,75,5799,4366,245,10485,4611,0.014901954029917584,0.8352621018093508,56.05050855293574
2021-07-05,8779,491556,591498,91163,127,6607,3566,603,10903,4169,0.014841977487666906,0.8310357769595164,55.992254243080076
2021-07-06,8861,497492,600937,94584,82,5936,2575,846,9439,3421,0.014745306080337873,0.8278604911995766,56.144001805665276
2021-07-07,9042,501199,610303,100062,181,3707,4196,1282,9366,5478,0.014815591599582503,0.8212297825834053,55.43010395930104
2021-07-08,9110,512085,623277,102082,68,10886,2717,-697,12974,2020,0.014616294199850147,0.8216009896081518,56.211306256860595
2021-07-09,9306,526941,636389,100142,196,14856,878,-2818,13112,-1940,0.014623131449475085,0.8280171404596874,56.62379110251451
2021-07-10,9357,543867,649309,96085,51,16926,-1427,-2630,12920,-4057,0.014410704302573967,0.8376089042351177,58.12407823020199
2021-07-11,9395,564437,662442,88610,38,20570,-3561,-3914,13133,-7475,0.014182373702150529,0.8520549723598443,60.07844598190527
2021-07-12,9462,584912,677061,82687,67,20475,-1670,-4253,14619,-5923,0.01397510711737938,0.8638985261298465,61.816952018600716
2021-07-13,9541,589486,689243,90216,79,4574,5267,2262,12182,7529,0.013842723103462785,0.8552658496350344,61.78450896132481
2021-07-14,9603,592556,701910,99751,62,3070,6723,2812,12667,9535,0.013681241184767278,0.844205097519625,61.70530042694991
2021-07-15,9743,595582,714601,109276,140,3026,7727,1798,12691,9525,0.013634181872121646,0.8334469165310432,61.12922097916453
2021-07-16,9845,604033,727016,113138,102,8451,1997,1865,12415,3862,0.013541655204287113,0.8308386610473497,61.35429151853733
2021-07-17,9902,615640,737184,111642,57,11607,-366,-1130,10168,-1496,0.013432196032469505,0.8351239310674133,62.173298323571
2021-07-18,10103,627481,746312,108728,201,11841,-1472,-1442,9128,-2914,0.013537233757463367,0.840775707746894,62.10838364842126
2021-07-19,10345,640171,751312,100796,242,12690,-5182,-2750,5000,-7932,0.013769246331750324,0.8520707775198586,61.882165297245045
2021-07-20,10610,652242,757525,94673,265,12071,-5499,-624,6213,-6123,0.014006138411273555,0.8610171281475859,61.47426955702168
2021-07-21,10692,662800,763429,89937,82,10558,-3661,-1075,5904,-4736,0.014005231658739712,0.868188135373427,61.99027310138421
2021-07-22,10865,673424,770487,86198,173,10624,-3141,-598,7058,-3739,0.014101470887892983,0.8740238316804826,61.981040036815465
2021-07-23,11021,687864,778520,79635,156,14440,-6185,-378,8033,-6563,0.014156347942249396,0.8835534090325232,62.41393702930768
2021-07-24,11181,702477,786880,73222,160,14613,-5843,-570,8360,-6413,0.014209282228548191,0.8927371390809272,62.82774349342635
2021-07-25,11333,716838,792273,64102,152,14361,-8012,-1108,5393,-9120,0.01430441274661638,0.9047866076466067,63.252272125650755
2021-07-26,11436,731504,794935,51995,103,14666,-10663,-1444,2662,-12107,0.014386081880908503,0.9202060545830791,63.96502273522211
2021-07-27,11606,746087,798502,40809,170,14583,-11310,124,3567,-11186,0.014534716256189715,0.9343583359841303,64.2845941754265
2021-07-28,11688,757122,804027,35217,82,11035,-4629,-963,5525,-5592,0.014536825255868272,0.9416624068594711,64.77772073921972
2021-07-29,11844,768562,807872,27466,156,11440,-5656,-2095,3845,-7751,0.014660738334785709,0.9513413015923314,64.89040864572779
2021-07-30,11952,779720,811326,19654,108,11158,-5412,-2400,3454,-7812,0.014731439643250679,0.9610440192968055,65.2376171352075
2021-07-31,12135,784668,814653,17850,183,4948,-1130,-674,3327,-1804,0.014895912738306984,0.9631929177207965,64.66155747836835
2021-08-01,12209,789261,817354,15884,74,4593,-735,-1231,2701,-1966,0.014937224262681776,0.9656293356367008,64.64583503972479
2021-08-02,12363,791422,818764,14979,154,2161,-197,-708,1410,-905,0.015099589136796439,0.9666057618556751,64.01536843808137
2021-08-03,12433,793928,820365,14004,70,2506,-497,-478,1601,-975,0.015155449098876719,0.9677741005528027,63.85651089841551
2021-08-04,12514,796381,823346,14451,81,2453,830,-383,2981,447,0.015198956453301528,0.9672494917082247,63.63920409141761
2021-08-05,12629,799151,825657,13877,115,2770,-77,-497,2311,-574,0.015295697850317988,0.9678970807490277,63.27904030406208
2021-08-06,12682,802373,827842,12787,53,3222,-645,-445,2185,-1090,0.015319348378072145,0.9692344674466867,63.26864847815802
2021-08-07,12750,806924,829850,10176,68,4551,-1856,-755,2008,-2611,0.015364222449840332,0.9723733204796048,63.2881568627451
2021-08-08,12770,808087,831499,10642,20,1163,610,-144,1649,466,0.015357805601690441,0.9718436221811452,63.280109631949884
2021-08-09,12783,809087,832226,10356,13,1000,-137,-149,727,-286,0.01536001038179533,0.9721962543828239,63.293984197762654
2021-08-10,12824,810308,833651,10519,41,1221,65,98,1425,163,0.01538293602478735,0.9719990739530091,63.186837180286965
2021-08-11,12866,811642,835609,11101,42,1334,378,204,1958,582,0.015397153453349592,0.9713179250103816,63.08425307010726
2021-08-12,12908,813898,836687,9881,42,2256,-865,-355,1078,-1220,0.015427513514611796,0.9727628133340186,63.05376510691044
2021-08-13,12976,815468,837897,9453,68,1570,-284,-144,1210,-428,0.015486390331985912,0.9732317934065882,62.84432799013563
2021-08-14,13005,816687,839260,9568,29,1219,24,91,1363,115,0.015495793913685866,0.9731036865810356,62.797923875432524
2021-08-15,13022,817764,840442,9656,17,1077,7,81,1182,88,0.01549422803715188,0.9730165793713308,62.79864844109968
2021-08-16,13050,818700,840955,9205,28,936,-465,14,513,-451,0.01551807171608469,0.9735360393837958,62.735632183908045
2021-08-17,13074,819620,841610,8916,24,920,-335,46,655,-289,0.015534511234419743,0.9738715081807489,62.69083677527918
2021-08-18,13087,820517,842639,9035,13,897,51,68,1029,119,0.015530968777851487,0.9737467646287438,62.69710399633224
2021-08-19,13121,821451,843370,8798,34,934,-212,-25,731,-237,0.015557821596689472,0.9740102208994866,62.6058227269263
2021-08-20,13132,822399,844339,8808,11,948,-73,83,969,10,0.015552994709470958,0.9740151763687334,62.62557112397198
2021-08-21,13152,823314,845230,8764,20,915,-156,112,891,-44,0.015560261703914911,0.9740709629331661,62.59990875912409
2021-08-22,13173,824227,845931,8531,21,913,19,-252,701,-233,0.015572192058217514,0.9743430610770855,62.56942230319593
2021-08-23,13193,824958,846416,8265,20,731,-107,-159,485,-266,0.015586898168276592,0.9746483998412129,62.529978018646254
2021-08-24,13203,825573,846900,8124,10,615,-200,59,484,-141,0.01558979808714134,0.9748175699610344,62.52919790956601
2021-08-25,13214,826302,847689,8173,11,729,165,-116,789,49,0.015588264092137564,0.974770228232288,62.53231421219918
2021-08-26,13216,827333,848263,7714,2,1031,-332,-127,574,-459,0.015580073632823783,0.9753260486429327,62.60086259079903
2021-08-27,13232,827674,848901,7995,16,341,381,-100,638,281,0.015587212171972939,0.9749947284783502,62.550937122128175
2021-08-28,13242,828125,849369,8002,10,451,116,-109,468,7,0.015590397106557926,0.9749884914565989,62.537758646730104
2021-08-29,13252,828838,849843,7753,10,713,-110,-139,474,-249,0.015593468440641389,0.9752836700425843,62.544370661032296
2021-08-30,13261,829668,850184,7255,9,830,-400,-98,341,-498,0.015597800005645836,0.9758687531169723,62.56451248020511
2021-08-31,13290,830197,850583,7096,29,529,-117,-42,399,-159,0.015624577495670616,0.9760329091928712,62.46779533483822
2021-09-01,13302,831293,851256,6661,12,1096,-491,56,673,-435,0.015626321576588005,0.9765487702876691,62.493835513456624
2021-09-02,13312,832130,851686,6244,10,837,-288,-129,430,-417,0.01563017356161778,0.9770384860147989,62.509765625
2021-09-03,13322,832952,852029,5755,10,822,-360,-129,343,-489,0.015635618036475285,0.9776099170333404,62.524545863984386
2021-09-04,13332,833437,852389,5620,10,485,-34,-101,360,-135,0.015640746185133784,0.9777660199744482,62.51402640264026
2021-09-05,13342,833765,852692,5585,10,328,13,-48,303,-35,0.015646915885219985,0.9778032396222787,62.491755359016636
2021-09-06,13359,834489,852909,5061,17,724,-403,-121,217,-524,0.01566286673021389,0.9784033232150205,62.46642712777903
2021-09-07,13372,835030,853171,4769,13,541,-245,-47,262,-292,0.015673294099307174,0.978736970665904,62.4461561471732
2021-09-08,13386,835700,853599,4513,14,670,-195,-61,428,-256,0.015681836553229328,0.9790311375716232,62.430897953085314
2021-09-09,13399,836187,853907,4321,13,487,-134,-58,308,-192,0.015691404333258774,0.9792483256373352,62.406672139711915
2021-09-10,13411,836644,854168,4113,12,457,-184,-24,261,-208,0.01570065841848442,0.9794841295857489,62.384907911416
2021-09-11,13431,837033,854436,3972,20,389,-105,-36,268,-141,0.015719141047427776,0.9796321784194486,62.32097386642841
2021-09-12,13437,837364,854742,3941,6,331,-15,-16,306,-31,0.0157205332135311,0.9796687187478795,62.31777926620526
2021-09-13,13443,837805,854929,3681,6,441,-85,-175,187,-260,0.015724112762580286,0.9799702665367533,62.32277021498177
2021-09-14,13445,838306,855119,3368,2,501,-186,-127,190,-313,0.015722957857327458,0.9803384090401452,62.35076236519152
2021-09-15,13455,838680,855424,3289,10,374,-45,-34,305,-79,0.01572904197216819,0.9804260811013018,62.33221850613155
2021-09-16,13464,839022,855600,3114,9,342,-131,-44,176,-175,0.01573632538569425,0.9806241234221599,62.315953654188945
2021-09-17,13469,839379,855806,2958,5,357,-134,-22,206,-156,0.015738379959944194,0.9808052292225107,62.3193258593808
2021-09-18,13475,839623,856006,2908,6,244,-24,-26,200,-50,0.015741712090803103,0.9808611154594711,62.309684601113176
2021-09-19,13479,839803,856161,2879,4,180,-18,-11,155,-29,0.015743534218447233,0.9808937804922205,62.30454781511982
2021-09-20,13482,840212,856252,2558,3,409,-222,-99,91,-321,0.015745364682359864,0.9812671970401237,62.32102062008604
2021-09-21,13486,840525,856358,2347,4,313,-142,-69,106,-211,0.0157480866646893,0.9815112371227921,62.325745217262345
2021-09-22,13490,840812,856585,2283,4,287,-43,-21,227,-64,0.015748583036126012,0.9815861823403398,62.32853965900667
2021-09-23,13493,841065,856750,2192,3,253,-4,-87,165,-91,0.015749051648672307,0.9816924423694193,62.3334321500037
2021-09-24,13497,841393,856931,2041,4,328,-96,-55,181,-151,0.01575039297212961,0.9818678516706713,62.339260576424394
2021-09-25,13500,841592,857064,1972,3,199,-28,-41,133,-69,0.015751449133320265,0.9819476725192051,62.340148148148145
2021-09-26,13503,841719,857232,2010,3,127,22,16,168,38,0.015751861806372138,0.981903382048267,62.335703177071764
2021-09-27,13507,841980,857335,1848,4,261,-107,-55,103,-162,0.01575463500265357,0.9820898481923636,62.33656622492041
2021-09-28,13512,842141,857439,1786,5,161,-50,-12,104,-62,0.0157585554191027,0.982158497572422,62.325414446418
2021-09-29,13516,842336,857616,1764,4,195,-16,-6,177,-22,0.0157599671647917,0.9821831682244734,62.32139686297721
2021-09-30,13519,842541,857765,1705,3,205,-35,-24,149,-59,0.0157607270056484,0.9822515490839565,62.32273097122568
2021-10-01,13524,842715,857916,1677,5,174,-22,-6,151,-28,0.015763781069475333,0.9822814821031429,62.31255545696539
2021-10-02,13529,842842,858071,1700,5,127,44,-21,155,23,0.015766760559440884,0.9822520514036718,62.29891344519181
2021-10-03,13534,842929,858198,1735,5,87,18,17,127,35,0.01577025348462709,0.982208068534301,62.28232599379341
2021-10-04,13534,843091,858347,1722,0,162,26,-39,149,-13,0.01576751593469774,0.9822263024161557,62.2942958474952
2021-10-05,13538,843239,858419,1642,4,148,-63,-17,72,-80,0.015770853161451458,0.9823163280402694,62.286822278032204
2021-10-06,13540,843414,858622,1668,2,175,19,7,203,26,0.015769453845813408,0.9822878985164601,62.290546528803546
2021-10-07,13541,843529,858771,1701,1,115,36,-3,149,33,0.015767882241016523,0.9822513801700337,62.294439110848536
2021-10-08,13541,843738,858921,1642,0,209,-47,-12,150,-59,0.01576512857410635,0.9823231705826263,62.309873716859904
2021-10-09,13543,843822,859021,1656,2,84,23,-9,100,14,0.01576562156222025,0.9823066025161201,62.30687440005907
2021-10-10,13547,843891,859161,1723,4,69,56,11,140,67,0.015767708264225216,0.9822268468889999,62.29357053222115
2021-10-11,13549,844189,859202,1464,2,298,-207,-52,41,-259,0.015769283591053094,0.982526809760685,62.306369473761904
2021-10-12,13550,844538,859345,1257,1,349,-131,-76,143,-207,0.015767823167645124,0.9827694348602715,62.327527675276755
2021-10-13,13550,844742,859623,1331,0,204,25,49,278,74,0.015762723891752546,0.9826889229348215,62.34258302583026
2021-10-14,13550,844839,859736,1347,0,97,6,10,113,16,0.015760652107158477,0.9826725878641815,62.349741697416974
2021-10-15,13550,844901,859860,1409,0,62,52,10,124,62,0.015758379271044124,0.9826029818807713,62.354317343173435
2021-10-16,13551,845121,860014,1342,1,220,-38,-29,154,-67,0.015756720239437964,0.98268284004679,62.36595085233562
2021-10-17,13551,845248,860145,1346,0,127,6,-2,131,4,0.015754320492475105,0.9826808270698545,62.37532285440189
2021-10-18,13552,845386,860252,1314,1,138,-14,-18,107,-32,0.015753523386170563,0.9827190172182105,62.38090318772137
2021-10-19,13552,845508,860358,1298,0,122,-17,1,106,-16,0.015751582480781255,0.9827397432231699,62.38990554899646
2021-10-20,13552,845650,860461,1259,0,142,-20,-19,103,-39,0.015749696964766562,0.9827871338735864,62.40038370720189
2021-10-21,13553,845763,860550,1234,1,113,-13,-12,89,-25,0.01574923014351287,0.9828168032072512,62.40411716963034
2021-10-22,13553,845884,860633,1196,0,121,-39,1,83,-38,0.015747711277629372,0.9828626139132476,62.413045082269605
2021-10-23,13555,846056,860749,1138,2,172,-49,-9,116,-58,0.015747912573816525,0.9829299830728818,62.416525267428995
2021-10-24,13556,846185,860880,1139,1,129,6,-5,131,1,0.01574667781804665,0.9829302574110212,62.4214370020655
2021-10-25,13557,846352,860962,1053,1,167,-78,-8,82,-86,0.01574633955970182,0.983030609945619,62.429150992107395
2021-10-26,13558,846525,860999,916,1,173,-114,-23,37,-137,0.015746824328483542,0.9831892952256622,62.43730638737277
2021-10-27,13559,846667,861104,878,1,142,-42,4,105,-38,0.015746065515895875,0.9832343131607797,62.44317427538904
2021-10-28,13560,846749,861235,926,1,82,52,-4,131,48,0.01574483155004151,0.9831799683013347,62.44461651917404
2021-10-29,13560,846799,861331,972,0,50,43,3,96,46,0.015743076703381164,0.9831284372674384,62.44830383480826
2021-10-30,13561,846942,861427,924,1,143,-53,5,96,-48,0.015742483112324086,0.9831848781150347,62.454243787331315
2021-10-31,13562,847021,861540,957,1,79,26,7,113,33,0.015741579032894585,0.9831476193792511,62.45546379590031
2021-11-01,13562,847066,861623,995,0,45,36,2,83,38,0.01574006264920969,0.9831051399509995,62.45878189057661
2021-11-02,13562,847201,861700,937,0,135,-51,-7,77,-58,0.01573865614482999,0.9831739584542184,62.46873617460552
2021-11-03,13563,847353,861832,916,1,152,-13,-8,132,-21,0.01573740589813328,0.9831997419450659,62.475337314753375
2021-11-04,13564,847403,861943,976,1,50,60,0,111,60,0.01573653942314051,0.983131135121464,62.4744175759363
2021-11-05,13565,847438,862061,1058,1,35,84,-2,118,82,0.015735545396439465,0.9830371632633885,62.47239218577221
2021-11-06,13566,847685,862130,879,1,247,-154,-25,69,-179,0.015735445930428124,0.9832449862549731,62.4859943977591
2021-11-07,13566,847808,862247,873,0,123,5,-11,117,-6,0.015733310756662535,0.9832542183388286,62.495061182367685
2021-11-08,13566,847885,862276,825,0,77,-26,-22,29,-48,0.0157327816151673,0.9833104481627692,62.50073713696005
2021-11-09,13566,848034,862370,770,0,149,-50,-5,94,-55,0.015731066711504343,0.9833760450850563,62.51172047766475
2021-11-10,13566,848093,862465,806,0,59,31,5,95,36,0.015729333943986134,0.9833361353794067,62.51606958572903
2021-11-11,13567,848137,862572,868,1,44,52,10,107,62,0.015728542081124824,0.9832651651108545,62.5147047984079
2021-11-12,13567,848311,862643,765,0,174,-82,-21,71,-103,0.015727247540407795,0.9833859429682963,62.52753003611705
2021-11-13,13567,848419,862697,711,0,108,-44,-10,54,-54,0.015726263102804346,0.9834495773139352,62.535490528488246
2021-11-14,13568,848527,862789,694,1,108,-20,3,92,-17,0.015725745228555302,0.9834698866119063,62.538841391509436
2021-11-15,13569,848604,862825,652,1,77,-37,-5,36,-42,0.01572624808043346,0.9835180946310086,62.539907141277915
2021-11-16,13569,848710,862904,625,0,106,-30,3,79,-27,0.0157248083216673,0.9835508932627499,62.547719065516986
2021-11-17,13570,848871,863034,593,1,161,-50,18,130,-32,0.01572359837503505,0.983589290804302,62.55497420781135
2021-11-18,13571,849007,863134,556,1,136,-53,16,100,-37,0.015722935256866258,0.9836329005693206,62.56038611745634
2021-11-19,13573,849111,863231,547,2,104,4,-13,97,-9,0.015723485370659766,0.9836428487855511,62.55883003020703
2021-11-20,13574,849265,863345,506,1,154,-51,10,114,-41,0.015722567455652144,0.983691340078416,62.56556652423751
2021-11-21,13574,849386,863456,496,0,121,-1,-9,111,-10,0.015720546269873625,0.9837050179742801,62.57448062472373
2021-11-22,13574,849448,863482,460,0,62,-18,-18,26,-36,0.015720072914085066,0.9837472002890622,62.57904818034478
2021-11-23,13574,849491,863551,486,0,43,25,1,69,26,0.015718816838843335,0.9837183906914588,62.58221600117872
2021-11-24,13575,849596,863633,462,1,105,-9,-15,82,-24,0.015718482271983587,0.9837465682761081,62.58534069981584
2021-11-25,13576,849638,863687,473,1,42,-20,31,54,11,0.01571865733766978,0.9837336905615113,62.58382439599293
2021-11-26,13576,849693,863757,488,0,55,18,-3,70,15,0.015717383477065888,0.9837176428092623,62.58787566293459
2021-11-27,13576,849779,863811,456,0,86,-40,8,54,-32,0.015716400925665452,0.9837557058199073,62.59421037124337
2021-11-28,13576,849831,863862,455,0,52,20,-21,51,-1,0.015715473073245494,0.9837578224299715,62.598040659988214
2021-11-29,13576,849902,863903,425,0,71,-17,-13,41,-30,0.015714727232108233,0.9837933193888666,62.603270477312904
2021-11-30,13576,849929,863947,442,0,27,9,8,44,17,0.015713926895978572,0.9837744676467423,62.605259281084265
2021-12-01,13576,849979,864017,462,0,50,18,2,70,20,0.015712653801950655,0.983752634496775,62.60894225103123
2021-12-02,13576,850046,864045,423,0,67,-34,-5,28,-39,0.01571214462209723,0.9837982975423734,62.61387743076016
2021-12-03,13577,850114,864087,396,1,68,-19,-8,42,-27,0.015712538205064998,0.9838291746085753,62.614274140089854
2021-12-04,13578,850175,864135,382,1,61,-20,6,48,-14,0.015712822649238834,0.9838451167930937,62.614155251141554
2021-12-05,13579,850228,864178,371,1,53,1,-12,43,-11,0.015713197975417103,0.9838574923221837,62.613447234700644
2021-12-06,13581,850281,864192,330,2,53,-29,-12,14,-41,0.015715257720506554,0.983902882692735,62.608129003755245
2021-12-07,13582,850319,864223,322,1,38,-10,2,31,-8,0.01571585111713065,0.9839115598636,62.60631718450891
2021-12-08,13583,850364,864264,317,1,45,-1,-4,41,-5,0.01571626262345765,0.983916951301917,62.60502098210999
2021-12-09,13583,850439,864300,278,0,75,-17,-22,36,-39,0.015715608006479233,0.9839627444174477,62.61054259000221
2021-12-10,13583,850475,864326,268,0,36,-9,-1,26,-10,0.015715135261463845,0.9839747965466734,62.613192961790475
2021-12-11,13583,850517,864358,258,0,42,-12,2,32,-10,0.015714553460487436,0.9839869591072218,62.61628506221012
2021-12-12,13583,850557,864390,250,0,40,-4,-4,32,-8,0.015713971702587953,0.9839968069968417,62.619229919752634
2021-12-13,13583,850595,864406,228,0,38,-17,-5,16,-22,0.01571368083979056,0.9840225542164215,62.622027534418024
2021-12-14,13583,850621,864426,222,0,26,-8,2,20,-6,0.015713317276435462,0.9840298649045726,62.62394169182066
2021-12-15,13583,850649,864449,217,0,28,1,-6,23,-5,0.015712899199374398,0.9840360738458833,62.62600309210042
2021-12-16,13583,850685,864489,221,0,36,4,0,40,4,0.015712172161820453,0.9840321854876117,62.62865346388868
2021-12-17,13583,850719,864527,225,0,34,10,-6,38,4,0.01571148153845976,0.9840282605401567,62.631156592799826
2021-12-18,13583,850751,864601,267,0,32,18,24,74,42,0.015710136814553764,0.9839810502185401,62.633512478833836
2021-12-19,13583,850797,864644,264,0,46,4,-7,43,-3,0.015709355526667624,0.9839853165002013,62.63689906500773
2021-12-20,13584,850817,864682,281,1,20,10,7,38,17,0.01570982164541415,0.9839652033926923,62.633760306242635
2021-12-21,13584,850837,864737,316,0,20,10,25,55,35,0.01570882245121927,0.9839257485223831,62.635232626619555
2021-12-22,13584,850858,864780,338,0,21,16,6,43,22,0.015708041351557622,0.9839011077962025,62.63677856301531
2021-12-23,13584,850910,864796,302,0,52,-19,-17,16,-36,0.01570775072965185,0.9839430339640793,62.64060659599529
2021-12-24,13584,850939,864865,342,0,29,11,29,69,40,0.01570649754585976,0.9838980650159274,62.642741460541814
2021-12-25,13584,850984,864945,377,0,45,2,33,80,35,0.01570504482944002,0.9838590893062564,62.64605418138987
2021-12-26,13584,851008,864992,400,0,24,6,17,47,23,0.015704191483851875,0.9838333764936554,62.647820965842165
2021-12-27,13584,851096,865034,354,0,88,-5,-41,42,-46,0.015703428998166544,0.9838873385323582,62.65429917550059
2021-12-28,13585,851138,865130,407,1,42,65,-12,96,53,0.015702842347392876,0.9838267081247904,62.652778800147225
2021-12-29,13587,851167,865157,403,2,29,2,-6,27,-4,0.015704664008960225,0.9838295245833993,62.64569073378965
2021-12-30,13587,851201,865210,422,0,34,13,6,53,19,0.015703701991424047,0.9838085551484611,62.648193125782
2021-12-31,13588,851222,865297,487,1,21,44,21,87,65,0.015703278758622763,0.983733908704179,62.64512805416544
2022-01-01,13588,851280,865415,547,0,58,47,13,118,60,0.015701137604501886,0.9836667956991733,62.64939652634678
2022-01-02,13588,851386,865518,544,0,106,86,-89,103,-3,0.015699269108210342,0.983672205546274,62.65719752722991
2022-01-03,13588,851408,865690,694,0,22,126,24,172,150,0.01569614989199367,0.983502177453823,62.6588166028849
2022-01-04,13588,851449,865805,768,0,41,73,1,115,74,0.015694065060839334,0.9834188991747564,62.66183397115102
2022-01-05,13589,851520,866064,955,1,71,160,27,259,187,0.015690526335236196,0.9832067837942693,62.66244756788579
2022-01-06,13589,851572,866331,1170,0,52,169,46,267,215,0.015685690573233557,0.9829637863587936,62.66627419236147
2022-01-07,13589,851648,866631,1394,0,76,217,7,300,224,0.015680260687651375,0.9827112115767841,62.67186695121054
2022-01-08,13589,851727,866909,1593,0,79,163,36,278,199,0.015675232348493325,0.9824872045393461,62.67768047685628
2022-01-09,13589,851839,867302,1874,0,112,239,42,393,281,0.015668129440494775,0.9821711468438906,62.68592243726543
2022-01-10,13589,851944,867662,2129,0,105,232,23,360,255,0.015661628606531114,0.9818846509355026,62.69364927514902
2022-01-11,13590,852126,868199,2483,1,182,274,80,537,354,0.01565309335762884,0.9814869632422981,62.70242825607064
2022-01-12,13590,852269,868611,2752,0,143,165,104,412,269,0.01564566877462984,0.9811860545169242,62.71295069904341
2022-01-13,13590,852563,869089,2936,0,294,107,77,478,184,0.015637063637901297,0.9809846862634322,62.7345842531273
2022-01-14,13591,852727,869643,3325,1,164,303,86,554,389,0.015628252052853873,0.9805483399509913,62.74203517033331
2022-01-15,13591,853003,870363,3769,0,276,355,89,720,444,0.015615323721251937,0.9800542991832144,62.762342726804505
2022-01-16,13591,853522,870929,3816,0,519,34,13,566,47,0.015605175622811962,0.9800132961469878,62.80052976234273
2022-01-17,13591,853987,871422,3844,0,465,-10,38,493,28,0.015596347119994676,0.9799924720743796,62.8347435803105
2022-01-18,13591,854204,872092,4297,0,217,281,172,670,453,0.015584364952321544,0.9794884025997257,62.85071002869546
2022-01-19,13591,854589,873104,4924,0,385,483,144,1012,627,0.015566301379904342,0.9787940497351977,62.87903759841071
2022-01-20,13591,855026,874259,5642,0,437,621,97,1155,718,0.01554573644652214,0.9780007983904083,62.9111912294901
2022-01-21,13591,855676,875743,6476,0,650,611,223,1484,834,0.015519393246648845,0.9770857431917811,62.95901699654183
2022-01-22,13591,856137,877568,7840,0,461,1099,265,1825,1364,0.015487118946907817,0.9755791004229871,62.992936502096974
2022-01-23,13597,856653,879307,9057,6,516,916,301,1739,1217,0.015463313723193378,0.974236529448759,63.003088916672795
2022-01-24,13597,857215,881300,10488,0,562,1200,231,1993,1431,0.015428344491092705,0.9726710541245887,63.0444215635802
2022-01-25,13606,857688,883490,12196,9,473,1229,479,2190,1708,0.015400287496179922,0.970795368368629,63.03748346317801
2022-01-26,13612,859305,886999,14082,6,1617,1375,511,3509,1886,0.01534612778593888,0.9687778678442704,63.12848956802821
2022-01-27,13615,861203,891148,16330,3,1898,1491,757,4149,2248,0.015278045846481169,0.966397276322227,63.253984575835474
2022-01-28,13617,862670,895706,19419,2,1467,2369,720,4558,3089,0.015202532973989233,0.9631173621701764,63.352427113167366
2022-01-29,13627,864447,901471,23397,10,1777,3142,836,5765,3978,0.015116404188265624,0.9589293499180783,63.436339619872314
2022-01-30,13639,866477,908093,27977,12,2030,3777,803,6622,4580,0.01501938678086936,0.9541720947083614,63.52936432289757
2022-01-31,13666,867519,913355,32170,27,1042,3732,461,5262,4193,0.014962418774737096,0.9498157890415009,63.480096590077565
2022-02-01,13678,869184,919743,36881,12,1665,3502,1209,6388,4711,0.014871545638292436,0.945029209246496,63.54613247550812
2022-02-02,13689,873212,928875,41974,11,4028,4521,572,9132,5093,0.014737182075090836,0.9400748216929081,63.78931989188399
2022-02-03,13713,877579,939192,47900,24,4367,4864,1062,10317,5926,0.014600848388827843,0.9343978653991942,63.99613505432801
2022-02-04,13738,883377,952371,55256,25,5798,5474,1882,13179,7356,0.014425050741780252,0.9275555429554239,64.30171786286213
2022-02-05,13767,891571,965145,59807,29,8194,2887,1664,12774,4551,0.014264177921452218,0.9237689673572365,64.76145856032542
2022-02-06,13794,899957,980970,67219,27,8386,5985,1427,15825,7412,0.014061592097617663,0.9174154153541902,65.24264172828767
2022-02-07,13832,905285,993652,74535,38,5328,6429,887,12682,7316,0.013920366486456023,0.9110684626005885,65.4485974551764
2022-02-08,13872,910435,1004469,80162,40,5150,3918,1709,10817,5627,0.013810281850410515,0.9063843682582539,65.63112745098039
2022-02-09,13889,923652,1018822,81281,17,13217,190,929,14353,1119,0.013632410764588907,0.9065881969568776,66.50241198070415
2022-02-10,13911,929100,1029912,86901,22,5448,4325,1295,11090,5620,0.013506979237061031,0.9021159089320253,66.78887211559197
2022-02-11,13950,945079,1040619,81590,39,15979,-5791,480,10707,-5311,0.01340548269827862,0.9081892604305707,67.74759856630824
2022-02-12,13989,960624,1053036,78423,39,15545,-2440,-727,12417,-3167,0.013284446115802309,0.9122423165019999,68.66995496461506
2022-02-13,14032,975674,1063208,73502,43,15050,-4623,-298,10172,-4921,0.01319779384654743,0.9176699197146748,69.53206955530217
2022-02-14,14085,975770,1073483,83628,53,96,8153,1973,10275,10126,0.013120841224313753,0.908975735992093,69.27724529641462
2022-02-15,14135,984861,1082965,83969,50,9091,466,-125,9482,341,0.013052130031903154,0.9094116615033727,69.67534488857446
2022-02-16,14191,992213,1095353,88949,56,7352,4011,969,12388,4980,0.012955640784295109,0.9058385744139104,69.91846945246988
2022-02-17,14255,1008870,1103889,80764,64,16657,-6600,-1585,8536,-8185,0.012913436042935477,0.9139234107777141,70.77306208347949
2022-02-18,14301,1020564,1112078,77213,46,11694,8017,-11568,8189,-3551,0.012859709480809799,0.9177090096198288,71.36312146003776
2022-02-19,14326,1031739,1121531,75466,25,11175,-1185,-562,9453,-1747,0.012773610359410485,0.9199380133050268,72.0186374424124
2022-02-20,14358,1043718,1129667,71591,32,11979,-3806,-69,8136,-3875,0.012709940185913194,0.9239165169912904,72.69243627246135
2022-02-21,14382,1055584,1135025,65059,24,11866,-5701,-831,5358,-6532,0.012671086539944055,0.9300094711570229,73.39618968154637
2022-02-22,14415,1064272,1140233,61546,33,8688,-3465,-48,5208,-3513,0.012642152963473255,0.9333811598155816,73.83087062088103
2022-02-23,14466,1071054,1147528,62008,51,6782,624,-162,7295,462,0.012606228344754986,0.9333576174176142,74.03940273745334
2022-02-24,14513,1082827,1154383,57043,47,11773,-4866,-99,6855,-4965,0.012572083961735403,0.938013640187009,74.61083166815958
2022-02-25,14555,1091226,1158907,53126,42,8399,-3664,-253,4524,-3917,0.012559247635919016,0.9415992827724744,74.97258673995191
2022-02-26,14585,1100117,1163582,48880,30,8891,-3630,-616,4675,-4246,0.012534569974440994,0.9454572174543779,75.42797394583476
2022-02-27,14609,1109056,1167539,43874,24,8939,-4662,-344,3957,-5006,0.01251264411724148,0.9499091679164465,75.91594222739407
2022-02-28,14664,1120433,1174839,39742,55,11377,-3993,-139,7300,-4132,0.012481710259873905,0.9536906759138912,76.40705128205128
2022-03-01,14690,1126008,1178473,37775,26,5575,-1603,-364,3634,-1967,0.012465283464279622,0.9554805243734901,76.65132743362832
2022-03-02,14710,1129828,1182669,38131,20,3820,548,-192,4196,356,0.012437968696228615,0.9553205503822286,76.80679809653297
2022-03-03,14730,1137499,1187338,35109,20,7671,-2664,-358,4669,-3022,0.012405902952655435,0.9580245894597832,77.22328581126952
2022-03-04,14754,1143134,1191065,33177,24,5635,-1962,30,3727,-1932,0.01238723327442247,0.959757863760584,77.47959875288058
2022-03-05,14779,1148415,1194124,30930,25,5281,-2344,97,3059,-2247,0.012376436617972672,0.961721730741531,77.7058664320996
2022-03-06,14798,1152865,1197793,30130,19,4450,-761,-39,3669,-800,0.012354388446083756,0.962491014724581,77.90681173131505
2022-03-07,14828,1156926,1200486,28732,30,4061,-1530,132,2693,-1398,0.012351664242648394,0.9637146955483029,78.02306447261937
2022-03-08,14852,1161139,1204055,28064,24,4213,-632,-36,3569,-668,0.012334984697542887,0.9643571099326858,78.18064907083222
2022-03-09,14863,1164852,1207927,28212,11,3713,274,-126,3872,148,0.012304551516772122,0.9643397324507192,78.37260310838997
2022-03-10,14881,1168549,1211473,28043,18,3697,-147,-22,3546,-169,0.012283393851947174,0.9645687522544869,78.52624151602714
2022-03-11,14896,1173761,1214021,25364,15,5212,-2240,-439,2548,-2679,0.012269968970882712,0.9668374764522195,78.797059613319
2022-03-12,14921,1178124,1216126,23081,25,4363,-1955,-328,2105,-2283,0.012269287886288099,0.9687515931737336,78.95744253066148
2022-03-13,14955,1180576,1218000,22469,34,2452,-578,-34,1874,-612,0.01227832512315271,0.9692742200328407,78.94189234369776
2022-03-14,14988,1184667,1219307,19652,33,4091,-2334,-483,1307,-2817,0.012292228290332132,0.9715904198040363,79.041032826261
2022-03-15,15019,1187307,1220878,18552,31,2640,-770,-330,1571,-1100,0.012301802473302,0.9725025760149663,79.0536653572142
2022-03-16,15031,1189556,1222584,17997,12,2249,-508,-47,1706,-555,0.012294451751372502,0.9729850873232432,79.1401769676003
2022-03-17,15043,1193225,1224167,15899,12,3669,-1711,-387,1583,-2098,0.012288356082135852,0.9747240368348437,79.32094661969022
2022-03-18,15061,1196098,1225683,14524,18,2873,-1332,-43,1516,-1375,0.01228784277827138,0.9758624375144307,79.41690458800876
2022-03-19,15073,1198669,1227168,13426,12,2571,-941,-157,1485,-1098,0.012282751831860022,0.9767766108633863,79.52424865653818
2022-03-20,15087,1200920,1228335,12328,14,2251,-1107,9,1167,-1098,0.012282479942361,0.977681170039118,79.59965533240538
2022-03-21,15093,1202740,1229197,11364,6,1820,-920,-44,862,-964,0.012278747832934835,0.9784761921807489,79.68859736301597
2022-03-22,15102,1204167,1230209,10940,9,1427,-311,-113,1012,-424,0.012275962864846543,0.9788312392447137,79.73559793404847
2022-03-23,15106,1205353,1231444,10985,4,1186,130,-85,1235,45,0.012266899672254687,0.9788126784490403,79.79299616046605
2022-03-24,15111,1207258,1232511,10142,5,1905,-805,-38,1067,-843,0.012260336824580064,0.97951093337098,79.89266097544835
2022-03-25,15116,1208909,1233401,9376,5,1651,-653,-113,890,-766,0.012255543817460825,0.9801427110890943,79.9754564699656
2022-03-26,15121,1210332,1234197,8744,5,1423,-507,-125,796,-632,0.012251690775459671,0.9806635407475468,80.04311884134647
2022-03-27,15126,1211717,1234791,7948,5,1385,-752,-44,594,-796,0.012249846330269657,0.9813134368488271,80.1082242496364
2022-03-28,15138,1213009,1235364,7217,12,1292,-533,-198,573,-731,0.012253878209175595,0.9819041189479376,80.13007002246003
2022-03-29,15148,1213901,1236106,7057,10,892,91,-251,742,-160,0.012254612468509982,0.982036330217635,80.13605756535516
2022-03-30,15159,1214728,1237007,7120,11,827,163,-100,901,63,0.01225457899591514,0.9819895926215454,80.13246256349363
2022-03-31,15167,1216040,1237736,6529,8,1312,-470,-121,729,-591,0.012253824725143326,0.982471221649851,80.17669941319971
2022-04-01,15175,1217108,1238377,6094,8,1068,-318,-117,641,-435,0.012253942054802375,0.9828251009183795,80.20481054365733
2022-04-02,15183,1218121,1239010,5706,8,1013,-324,-64,633,-388,0.01225413838467809,0.983140571908217,80.22926957781729
2022-04-03,15190,1218930,1239622,5502,7,809,-159,-45,612,-204,0.012253735412891995,0.9833078148016089,80.24555628703094
2022-04-04,15200,1219664,1240110,5246,10,734,-200,-56,488,-256,0.012256977203635161,0.9835127529009523,80.24105263157895
2022-04-05,15205,1220235,1240678,5238,5,571,-16,8,568,-8,0.012255395840016507,0.9835227190294339,80.25221966458402
2022-04-06,15207,1220769,1241431,5455,2,534,294,-77,753,217,0.012249573274712811,0.9833563041361139,80.2767804300651
2022-04-07,15212,1221596,1242105,5297,5,827,-105,-53,674,-158,0.01224695174723554,0.9834885134509562,80.30475940047332
2022-04-08,15214,1222380,1242697,5103,2,784,-153,-41,592,-194,0.012242726907685462,0.9836508819124855,80.3457341921914
2022-04-09,15217,1223059,1243147,4871,3,679,-189,-43,450,-232,0.012240708460061442,0.9838410099529662,80.37451534468029
2022-04-10,15220,1223655,1243517,4642,3,596,-228,-1,370,-229,0.012239478833019573,0.9840275605399845,80.39783180026281
2022-04-11,15224,1224308,1243829,4297,4,653,-284,-61,312,-345,0.01223962457861973,0.98430572048087,80.41960063058329
2022-04-12,15229,1224805,1244184,4150,5,497,-148,1,355,-147,0.01224015097445394,0.9844243295203925,80.42583229365027
2022-04-13,15232,1225348,1244583,4003,3,543,-92,-55,399,-147,0.012238637358858348,0.9845450243173818,80.44564075630252
2022-04-14,15234,1226139,1244955,3582,2,791,-388,-33,372,-421,0.012236586864585466,0.9848862007060496,80.48700275699095
2022-04-15,15238,1226739,1245265,3288,4,600,-290,-4,310,-294,0.012236752819680952,0.9851228453381409,80.50525003281271
2022-04-16,15240,1227338,1245458,2880,2,599,-368,-40,193,-408,0.012236462409812294,0.9854511352450264,80.53398950131233
2022-04-17,15244,1227793,1245653,2616,4,455,-264,0,195,-264,0.012237758027315793,0.985662138653381,80.5427053266859
2022-04-18,15250,1228205,1245823,2368,6,412,-208,-40,170,-248,0.012240904205493076,0.9858583442431228,80.53803278688524
2022-04-19,15252,1228519,1246002,2231,2,314,-121,-16,179,-137,0.012240750817414419,0.9859687223616014,80.54805927091529
2022-04-20,15254,1228783,1246233,2196,2,264,-10,-25,231,-35,0.012240086725355532,0.9859978029790577,80.55480529697128
2022-04-21,15258,1229206,1246392,1928,4,423,-263,-5,159,-268,0.012241734542583713,0.9862114005866534,80.561410407655
2022-04-22,15261,1229616,1246607,1730,3,410,-186,-12,215,-198,0.012242029765595732,0.9863702032797826,80.57243955179871
2022-04-23,15264,1229971,1246779,1544,3,355,-161,-25,172,-186,0.012242747110754994,0.9865188618030942,80.57986111111111
2022-04-24,15265,1230220,1246914,1429,1,249,-107,-8,135,-115,0.012242223601627699,0.986611747081194,80.59089420242384
2022-04-25,15266,1230368,1247015,1381,1,148,-42,-6,101,-48,0.012242033977137403,0.9866505214452111,80.59530983885759
2022-04-26,15268,1230600,1247214,1346,2,232,-30,-5,199,-35,0.01224168426589182,0.9866791104012623,80.59994760282945
2022-04-27,15271,1230742,1247344,1331,3,142,-24,9,130,-15,0.012242813530188945,0.9866901191652022,80.59341235020628
2022-04-28,15272,1230989,1247457,1196,1,247,-102,-33,113,-135,0.012242506154520758,0.9867987433634987,80.60430853850184
2022-04-29,15273,1231171,1247583,1139,1,182,-28,-29,126,-57,0.01224207126900575,0.9868449634212714,80.61094742355792
2022-04-30,15274,1231413,1247734,1047,1,242,-94,2,151,-92,0.012241391193956404,0.9869194876472068,80.62151368338353
2022-05-01,15275,1231573,1247815,967,1,160,-73,-7,81,-80,0.012241397963640443,0.9869836474156826,80.62671031096563
2022-05-02,15277,1231709,1247903,917,2,136,-48,-2,88,-50,0.012242137409718544,0.9870230298348509,80.62505727564313
2022-05-03,15278,1231833,1247943,832,1,124,-85,0,40,-85,0.012242546334247638,0.987090756548977,80.62789632150805
2022-05-04,15280,1231950,1248005,775,2,117,-36,-21,62,-57,0.012243540690942745,0.9871354682072588,80.625
2022-05-05,15281,1232106,1248091,704,1,156,-77,6,86,-71,0.012243498270558798,0.9871924402948182,80.6299325960343
2022-05-06,15282,1232228,1248180,670,1,122,-34,0,89,-34,0.01224342642888045,0.987219792017177,80.63263970684466
2022-05-07,15283,1232328,1248242,631,1,100,-38,-1,62,-39,0.012243619426361235,0.9872508696230379,80.63390695544068
2022-05-08,15284,1232444,1248320,592,1,116,-30,-9,78,-39,0.012243655472955653,0.9872821071520123,80.63622088458519
2022-05-09,15285,1232527,1248422,610,1,83,11,7,102,18,0.01224345613902991,0.987267927031084,80.6363755315669
2022-05-10,15287,1232618,1248572,667,2,91,71,-14,150,57,0.012243587073873193,0.9872222026443008,80.63177863544188
2022-05-11,15288,1232696,1248701,717,1,78,59,-9,129,50,0.012243123053477174,0.9871826802413067,80.63160648874934
2022-05-12,15290,1232729,1248801,782,2,33,65,0,100,65,0.012243744199436099,0.9871300551488988,80.62321778940483
2022-05-13,15291,1232772,1248902,839,1,43,50,7,101,57,0.012243554738482283,0.9870846551610934,80.62075730822052
2022-05-14,15292,1232867,1249016,857,1,95,12,6,114,18,0.01224323787685666,0.9870706219936334,80.62169761967041
2022-05-15,15293,1232939,1249109,877,1,72,10,10,93,20,0.012243126900854929,0.9870547726419392,80.62113385208919
2022-05-16,15293,1233010,1249179,876,0,71,15,-16,70,-1,0.01224244083514052,0.9870562985769054,80.62577649905185
2022-05-17,15293,1233102,1249254,859,0,92,-31,14,75,-17,0.012241705850051311,0.9870706837840824,80.63179232328517
2022-05-18,15294,1233206,1249367,867,1,104,0,8,113,8,0.012241399044476122,0.9870646495385264,80.63332025630966
2022-05-19,15294,1233387,1249457,776,0,181,-81,-10,90,-91,0.012240517280706738,0.9871384129265753,80.64515496273049
2022-05-20,15294,1233494,1249539,751,0,107,-25,0,82,-25,0.012239714006525607,0.9871592643366873,80.65215117039362
2022-05-21,15294,1233575,1249632,763,0,81,17,-5,93,12,0.01223880310363371,0.9871506171416865,80.65744736497973
2022-05-22,15296,1233664,1249742,782,2,89,13,6,110,19,0.012239326196927046,0.9871349446525763,80.65271966527196
2022-05-23,15297,1233779,1249800,724,1,115,-46,-12,58,-58,0.012239558329332692,0.9871811489838375,80.65496502582205
2022-05-24,15300,1233873,1249948,775,3,94,32,19,148,51,0.012240509205182935,0.9871394650017441,80.64529411764705
2022-05-25,15300,1233937,1250076,839,0,64,51,13,128,64,0.012239255853244122,0.9870895849532348,80.64947712418301
2022-05-26,15300,1234021,1250200,879,0,84,38,2,124,40,0.012238041913293873,0.9870588705807071,80.65496732026143
2022-05-27,15300,1234087,1250310,923,0,66,40,4,110,44,0.01223696523262231,0.9870248178451744,80.65928104575164
2022-05-28,15300,1234180,1250414,934,0,93,14,-3,104,11,0.012235947454203169,0.987017099936501,80.66535947712418
2022-05-29,15300,1234280,1250503,923,0,100,-1,-10,89,-11,0.012235076605174078,0.987026820407468,80.6718954248366
2022-05-30,15303,1234376,1250584,905,3,96,-18,0,81,-18,0.012236683021692266,0.9870396550731498,80.66235378683918
2022-05-31,15303,1234487,1250716,926,0,111,25,-4,132,21,0.012235391567710016,0.9870242325196128,80.66960726654904
2022-06-01,15303,1234566,1250880,1011,0,79,94,-9,164,85,0.012233787413660782,0.986957981580967,80.6747696530092
2022-06-02,15303,1234723,1251038,1012,0,157,7,-6,158,1,0.012232242345955918,0.9869588293880761,80.6850290792655
2022-06-03,15303,1234863,1251211,1045,0,140,20,13,173,33,0.012230551042150364,0.9869342580907616,80.69417761223289
2022-06-04,15303,1234976,1251384,1105,0,113,63,-3,173,60,0.012228860205979939,0.9868881174763302,80.70156178527087
2022-06-05,15303,1235069,1251579,1207,0,93,98,4,195,102,0.012226954910556984,0.9868086632965238,80.70763902502777
2022-06-06,15303,1235172,1251726,1251,0,103,53,-9,147,44,0.01222551900336016,0.986775060995777,80.71436973142521
2022-06-07,15303,1235274,1251986,1409,0,102,158,0,260,158,0.012222980129170773,0.9866516079253282,80.7210350911586
2022-06-08,15303,1235370,1252274,1601,0,96,195,-3,288,192,0.01222016906843071,0.9865013567318335,80.72730837090766
2022-06-09,15303,1235508,1252550,1739,0,138,131,7,276,138,0.012217476348249571,0.9863941559219193,80.73632621054695
2022-06-10,15303,1235666,1252883,1914,0,158,167,8,333,175,0.012214229101999149,0.9862580943312345,80.74665098346729
2022-06-11,15303,1235838,1253197,2056,0,172,137,5,314,142,0.012211168714894785,0.9861482272938732,80.75789060968438
2022-06-12,15303,1236002,1253519,2214,0,164,148,10,322,158,0.0122080319484587,0.9860257403358066,80.76860746258903
2022-06-13,15304,1236184,1253867,2379,1,182,179,-14,348,165,0.01220544124695841,0.9858972283344246,80.77522216414009
2022-06-14,15304,1236374,1254384,2706,0,190,267,60,517,327,0.012200410719524483,0.9856423551320808,80.7876372190277
2022-06-15,15304,1236528,1255114,3282,0,154,534,42,730,576,0.01219331471085495,0.9851917833758527,80.79769994772609
2022-06-16,15305,1236820,1255810,3685,1,292,366,37,696,403,0.012187353182408166,0.9848782857279366,80.81149950996407
2022-06-17,15305,1237109,1256496,4082,0,289,366,31,686,397,0.012180699341661255,0.9845705835911933,80.83038222803006
2022-06-18,15305,1237400,1257229,4524,0,291,410,32,733,442,0.012173597650070115,0.9842280125577759,80.84939562234564
2022-06-19,15308,1237676,1257964,4980,3,276,421,35,735,456,0.012168869697384026,0.9838723524679561,80.85158087274628
2022-06-20,15309,1238059,1258665,5297,1,383,301,16,701,317,0.012162886868229434,0.9836286859490015,80.87131752563852
2022-06-21,15311,1238392,1259618,5915,2,333,576,42,953,618,0.012155272471495327,0.9831488594161087,80.88250277578211
2022-06-22,15311,1238754,1260844,6779,0,362,856,8,1226,864,0.012143453115532136,0.9824799895942717,80.9061459081706
2022-06-23,15311,1239359,1261898,7228,0,605,438,11,1054,449,0.012133310299247642,0.9821388099513589,80.94565998301874
2022-06-24,15313,1240028,1263164,7823,2,669,587,8,1266,595,0.012122733073456812,0.9816840885269055,80.97877620322602
2022-06-25,15313,1240738,1264209,8158,0,710,295,40,1045,335,0.012112712375880887,0.9814342406991249,81.02514203617841
2022-06-26,15313,1241429,1265264,8522,0,691,335,29,1055,364,0.012102612577296121,0.9811620341683632,81.0702670933194
2022-06-27,15313,1242286,1266102,8503,0,857,-30,11,838,-19,0.012094602172652756,0.9811895092180567,81.12623261281264
2022-06-28,15314,1243032,1267352,9006,1,746,474,29,1250,503,0.012083462210972168,0.980810382592997,81.16964868747552
2022-06-29,15314,1243738,1268486,9434,0,706,426,2,1134,428,0.012072659848039315,0.9804901276009352,81.21575029384877
2022-06-30,15315,1244833,1269741,9593,1,1095,125,34,1255,159,0.012061514907370873,0.9803834010243034,81.28194580476656
2022-07-01,15316,1245980,1270841,9545,1,1147,-97,49,1100,-48,0.012051861719916181,0.9804373639188537,81.35152781405067
2022-07-02,15317,1247144,1271824,9363,1,1164,-154,-28,983,-182,0.01204333303979167,0.9805947992804036,81.42221061565581
2022-07-03,15320,1248357,1272755,9078,3,1213,-342,57,931,-285,0.012036880625100667,0.9808305604770753,81.48544386422977
2022-07-04,15323,1249496,1273492,8673,3,1139,-396,-9,737,-405,0.012032270324430779,0.9811573217578123,81.54382301115969
2022-07-05,15325,1250388,1274768,9055,2,892,330,52,1276,382,0.012021795338445898,0.9808749513636991,81.59138662316477
2022-07-06,15327,1251237,1276284,9720,2,849,679,-14,1516,665,0.012009082617975309,0.9803750575890633,81.63613231552164
2022-07-07,15329,1252398,1277760,10033,2,1161,274,39,1476,313,0.011996775607312797,0.9801512021036815,81.70121990997455
2022-07-08,15331,1253562,1278911,10018,2,1164,-37,22,1151,-15,0.01198754252641505,0.9801792306110433,81.7664862044224
2022-07-09,15334,1254809,1280389,10246,3,1247,228,0,1478,228,0.011976047904191617,0.9800216965312886,81.83181166036259
2022-07-10,15338,1255908,1282064,10818,4,1099,595,-23,1675,572,0.011963521321868486,0.979598522382658,81.88212283218151
2022-07-11,15342,1257072,1282876,10462,4,1164,-273,-83,812,-356,0.01195906697139864,0.9798858190503213,81.93664450527963
2022-07-12,15346,1257799,1284470,11325,4,727,744,119,1594,863,0.011947340148076638,0.9792357937515084,81.96266127981232
2022-07-13,15350,1258663,1286491,12478,4,864,1153,0,2021,1153,0.011931680827926507,0.978369067486675,81.99758957654723
2022-07-14,15356,1260234,1288240,12650,6,1571,149,23,1749,172,0.011920139104514687,0.9782602620629697,82.06785621255536
2022-07-15,15359,1261863,1289853,12631,3,1629,-45,26,1613,-19,0.011907558458211905,0.9782998527739207,82.15788788332574
2022-07-16,15364,1263230,1291984,13390,5,1367,788,-29,2131,759,0.011891788133599177,0.9777443064310394,82.22012496745639
2022-07-17,15367,1264902,1293986,13717,3,1672,301,26,2002,327,0.01187570808339503,0.9775237135486783,82.31287824559121
2022-07-18,15369,1266257,1295850,14224,2,1355,493,14,1864,507,0.011860169001041787,0.9771632519195894,82.39033118615394
2022-07-19,15371,1267430,1298335,15534,2,1173,1295,15,2485,1310,0.011839009192542757,0.9761964362048315,82.45592349229068
2022-07-20,15373,1268249,1301285,17663,2,819,2142,-13,2950,2129,0.011813707220170831,0.9746127865917151,82.49847134586612
2022-07-21,15377,1270067,1304168,18724,4,1818,1019,42,2883,1061,0.011790658872169842,0.9738522951030849,82.5952396436236
2022-07-22,15383,1271839,1306633,19411,6,1772,668,19,2465,687,0.011773007416772728,0.9733712526776838,82.67821621270234
2022-07-23,15384,1273936,1309294,19974,1,2097,576,-13,2661,563,0.011749843808953527,0.9729946062534465,82.80915236609465
2022-07-24,15384,1275596,1311445,20465,0,1660,487,4,2151,491,0.011730572002638311,0.9726645036581786,82.91705668226729
2022-07-25,15386,1277873,1313613,20354,2,2277,-116,5,2168,-111,0.011712734268007396,0.9727925956883801,83.05427011568959
2022-07-26,15389,1279485,1316587,21713,3,1612,1353,6,2974,1359,0.011688555332841659,0.9718195607278516,83.1428292936513
2022-07-27,15390,1281386,1319866,23090,1,1901,1357,20,3279,1377,0.011660274603634006,0.970845525227561,83.26094866796622
2022-07-28,15392,1284419,1323023,23212,2,3033,109,13,3157,122,0.011633962523705181,0.970821368940676,83.44718035343035
2022-07-29,15395,1286877,1326010,23738,3,2458,469,57,2987,526,0.011610018023996803,0.9704881561979171,83.59058135758363
2022-07-30,15400,1289636,1328639,23603,5,2759,-138,3,2629,-135,0.011590808338457624,0.9706443962581258,83.7425974025974
2022-07-31,15402,1292113,1330837,23322,2,2477,-325,44,2198,-281,0.0115731678635325,0.9709025222472775,83.89254642254252
2022-08-01,15404,1294595,1332323,22324,2,2482,-1015,17,1486,-998,0.01156176092434042,0.9716825424465388,84.04278109581927
2022-08-02,15408,1296794,1334316,22114,4,2199,-220,10,1993,-210,0.011547489500238324,0.9718792250111667,84.16368120456906
2022-08-03,15412,1298981,1336848,22455,4,2187,355,-14,2532,341,0.011528610582504518,0.9716744162387946,84.28373994290163
2022-08-04,15414,1302829,1339662,21419,2,3848,-995,-41,2814,-1036,0.011505887305902534,0.972505751450739,84.52244712598936
2022-08-05,15418,1305863,1342231,20950,4,3034,-468,-1,2569,-469,0.011486845408875223,0.9729048129569351,84.69730185497471
2022-08-06,15421,1308676,1344587,20490,3,2813,-474,14,2356,-460,0.011468949201502023,0.9732921707557786,84.86323844108684
2022-08-07,15426,1311714,1346411,19271,5,3038,-1186,-33,1824,-1219,0.011457125647369192,0.974230008518944,85.03267211201867
2022-08-08,15429,1314435,1348711,18847,3,2721,-417,-7,2300,-424,0.011439811790665309,0.9745861048067377,85.19249465292631
2022-08-09,15434,1316556,1351009,19019,5,2121,155,17,2298,172,0.011424054169883398,0.9744983194042379,85.30231955423092
2022-08-10,15438,1318226,1353233,19569,4,1670,518,32,2224,550,0.01140823494549719,0.9741308407347441,85.3883922787926
2022-08-11,15443,1320606,1355451,19402,5,2380,-167,0,2218,-167,0.011393255824076267,0.9742926892967728,85.51486110211746
2022-08-12,15445,1323161,1358309,19703,2,2555,301,0,2858,301,0.011370755844215123,0.9741237082283928,85.66921333764972
2022-08-13,15449,1325748,1360596,19399,4,2587,-340,36,2287,-304,0.011354582844576935,0.9743876948043357,85.81448637452262
2022-08-14,15452,1328058,1362705,19195,3,2310,-204,0,2109,-204,0.011339211348017363,0.97457483461204,85.94732073517991
2022-08-15,15455,1330248,1364607,18904,3,2190,-262,-29,1902,-291,0.011325605100955807,0.9748213221828702,86.0723390488515
2022-08-16,15457,1332050,1367069,19562,2,1802,646,12,2462,658,0.011306671426241104,0.9743838825984643,86.17778352849841
2022-08-17,15461,1334190,1369473,19822,4,2140,260,0,2404,260,0.011289744303100535,0.9742360747528429,86.29390078261432
2022-08-18,15463,1336607,1371533,19463,2,2417,-360,1,2060,-359,0.01127424567983417,0.9745350640487688,86.43904805018431
2022-08-19,15468,1338895,1373750,19387,5,2288,-59,-17,2217,-76,0.011259690627843493,0.9746278434940855,86.55902508404448
2022-08-20,15471,1341152,1376074,19451,3,2257,134,-70,2324,64,0.011242854672059788,0.9746220043398829,86.68812617154677
2022-08-21,15475,1343872,1377971,18624,4,2720,-837,10,1897,-827,0.011230279882522927,0.9752541962058708,86.84148626817448
2022-08-22,15479,1345918,1379517,18120,4,2046,-496,-8,1546,-504,0.01122059387452275,0.9756443740816532,86.95122423929195
2022-08-23,15482,1347925,1380987,17580,3,2007,-375,-165,1470,-540,0.011210822404555582,0.9760591518964334,87.06400981785299
2022-08-24,15485,1349999,1383204,17720,3,2074,140,0,2217,140,0.01119502257078493,0.9759941411389788,87.18107846302874
2022-08-25,15489,1353005,1385687,17193,4,3006,-527,0,2483,-527,0.01117784896589201,0.976414587132592,87.35263735554264
2022-08-26,15492,1355279,1387575,16804,3,2274,-470,81,1888,-389,0.01116480190259986,0.9767248617191864,87.48250710043894
2022-08-27,15494,1356817,1389487,17176,2,1538,372,0,1912,372,0.01115087798590415,0.9764877253259656,87.57047889505616
2022-08-28,15496,1359554,1390976,15926,2,2737,-1248,-2,1489,-1250,0.011140379129474557,0.9774101062850833,87.73580278781621
2022-08-29,15500,1361353,1392192,15339,4,1799,-581,-6,1216,-587,0.011133521813083252,0.9778486013423436,87.82922580645162
2022-08-30,15502,1363254,1393909,15153,2,1901,-138,-48,1717,-186,0.011121242491439542,0.9780078900416024,87.9405238033802
2022-08-31,15505,1364790,1395840,15545,3,1536,378,14,1931,392,0.011108006648326455,0.9777553301237965,88.02257336343115
2022-09-01,15509,1366562,1397542,15471,4,1772,-33,-41,1702,-74,0.011097340902813654,0.9778325087904335,88.11412728093366
2022-09-02,15512,1368792,1399042,14738,3,2230,-723,-10,1500,-733,0.011087587077442992,0.978378061559267,88.24084579680247
2022-09-03,15516,1371077,1400548,13955,4,2285,-817,34,1506,-783,0.011078520693328611,0.978957522341255,88.36536478473833
2022-09-04,15519,1372751,1401805,13535,3,1674,-398,-22,1257,-420,0.011070726670257276,0.9792738647672109,88.4561505251627
2022-09-05,15523,1374574,1402797,12700,4,1823,-820,-15,992,-835,0.011065749356464264,0.9798809093546679,88.55079559363526
2022-09-06,15526,1375989,1404184,12669,3,1415,-25,-6,1387,-31,0.01105695549870957,0.9799207226403377,88.62482287775345
2022-09-07,15530,1377235,1405670,12905,4,1246,236,0,1486,236,0.011048112288090377,0.9797712123044526,88.68222794591114
2022-09-08,15531,1379171,1406988,12286,1,1936,-554,-65,1318,-619,0.011038473675681669,0.9802293978342388,88.80117184984869
2022-09-09,15533,1381317,1408154,11304,2,2146,-961,-21,1166,-982,0.01103075373858257,0.9809417151817201,88.92789544840018
2022-09-10,15534,1382928,1409279,10817,1,1611,-487,0,1125,-487,0.011022657685241886,0.9813017862325345,89.02587871765161
2022-09-11,15537,1384356,1410134,10241,3,1428,-520,-56,855,-576,0.011018101825783933,0.9817194677952592,89.10059857115273
2022-09-12,15540,1385702,1410887,9645,3,1346,-585,-11,753,-596,0.011014347711758632,0.982149527212314,89.17001287001287
2022-09-13,15542,1386777,1411948,9629,2,1075,2,-18,1061,-16,0.011007487527869298,0.982172856224167,89.22770557199846
2022-09-14,15546,1387757,1413176,9873,4,980,279,-35,1228,244,0.011000752914003634,0.9820128561481373,89.26778592564004
2022-09-15,15551,1389381,1414292,9360,5,1624,-526,13,1116,-513,0.010995607696289027,0.9823862398995399,89.34351488650248
2022-09-16,15554,1390717,1415313,9042,3,1336,-318,0,1021,-318,0.010989795190180547,0.9826215119906339,89.4121769319789
2022-09-17,15556,1392001,1416206,8649,2,1284,-362,-31,893,-393,0.01098427771101097,0.982908559912894,89.48322190794549
2022-09-18,15559,1392980,1417000,8461,3,979,-188,0,794,-188,0.010980239943542696,0.9830486944248412,89.52889003149302
2022-09-19,15563,1394148,1417626,7915,4,1168,-515,-31,626,-546,0.010978212871377924,0.9834385091695553,89.58092912677505
2022-09-20,15566,1394905,1418578,8107,3,757,227,-35,952,192,0.010972960246105607,0.9833121618973366,89.61229602980856
2022-09-21,15570,1395674,1419552,8308,4,769,230,-29,974,201,0.010968249137756137,0.9831792001983725,89.63866409762363
2022-09-22,15572,1396845,1420440,8023,2,1171,-319,34,888,-285,0.010962800259074652,0.983388949902847,89.7023503724634
2022-09-23,15574,1398121,1421152,7457,2,1276,-552,-14,712,-566,0.01095871518317534,0.9837941332102407,89.77276229613459
2022-09-24,15575,1399122,1421839,7142,1,1001,-306,-9,687,-315,0.01095412349780812,0.9840228042696817,89.83126805778491
2022-09-25,15578,1400142,1422419,6699,3,1020,-443,0,580,-443,0.010951765970505175,0.984338651269422,89.879445371678
2022-09-26,15581,1401070,1422965,6314,3,928,-371,-14,546,-385,0.01094967198771579,0.9846131141665466,89.92169950580836
2022-09-27,15583,1401726,1423705,6396,2,656,74,8,740,82,0.010945385455554346,0.9845621108305442,89.95225566322274
2022-09-28,15586,1402392,1424400,6422,3,666,53,-27,695,26,0.010942151081156978,0.9845492839090143,89.97767226998589
2022-09-29,15589,1403358,1425181,6234,3,966,-157,-31,781,-188,0.010938259771916689,0.984687558983736,90.02232343319007
2022-09-30,15593,1404297,1425915,6025,4,939,-246,37,734,-209,0.010935434440341816,0.984839208508221,90.05944975309434
2022-10-01,15595,1405108,1426518,5815,2,811,-158,-52,603,-210,0.01093221396435236,0.9849914266767051,90.09990381532542
2022-10-02,15596,1405927,1427069,5546,1,819,-252,-17,551,-269,0.010928693707171833,0.9851850190845712,90.14664016414466
2022-10-03,15599,1406649,1427453,5205,3,722,-342,1,384,-341,0.010927855418006758,0.9854257898508743,90.1755881787294
2022-10-04,15601,1407130,1428121,5390,2,481,178,7,668,185,0.010924144382723874,0.9853016656151684,90.19485930389078
2022-10-05,15601,1407613,1428721,5507,0,483,156,-39,600,117,0.010919556722411164,0.9852259468433655,90.22581885776553
2022-10-06,15601,1408456,1429401,5344,0,843,-172,9,680,-163,0.010914362029969198,0.9853470089918784,90.27985385552208
2022-10-07,15601,1409218,1429921,5102,0,762,-243,1,520,-242,0.010910392951778454,0.985521577765485,90.32869687840522
2022-10-08,15601,1410005,1430421,4815,0,787,-279,-8,500,-287,0.01090657925184264,0.9857272788920185,90.37914236266906
2022-10-09,15602,1410653,1430886,4631,1,648,-188,4,465,-184,0.010903733770544963,0.9858598099359418,90.41488270734521
2022-10-10,15602,1411237,1431382,4543,0,584,-78,-10,496,-88,0.01089995542769156,0.9859261888161232,90.45231380592232
2022-10-11,15603,1411650,1432120,4867,1,413,338,-14,738,324,0.010895036728765746,0.9857065050414769,90.47298596423765
2022-10-12,15603,1412072,1432872,5197,0,422,326,4,752,330,0.010889318794700434,0.9854836998699116,90.50003204511953
2022-10-13,15605,1412824,1433580,5151,2,752,-48,2,708,-46,0.01088533601194213,0.9855215614057116,90.53662287728292
2022-10-14,15606,1413399,1434192,5187,1,575,36,0,612,36,0.010881388266006225,0.9855019411626895,90.56766628219916
2022-10-15,15608,1413956,1434769,5205,2,557,18,0,577,18,0.010878406210337692,0.9854938321081651,90.59174782162994
2022-10-16,15610,1414545,1435287,5132,2,589,-75,2,518,-73,0.010875873605766652,0.9855485348923246,90.6178731582319
2022-10-17,15611,1415045,1435735,5079,1,500,-53,0,448,-53,0.010873176456658088,0.9855892626424793,90.64409711101146
2022-10-18,15612,1415449,1436432,5371,1,404,294,-2,697,292,0.01086859663388173,0.9853922775321073,90.66416858826544
2022-10-19,15614,1415986,1437323,5723,2,537,343,9,891,352,0.010863250640252748,0.9851550416990474,90.68694761111823
2022-10-20,15615,1416863,1438107,5629,1,877,-110,16,784,-94,0.0108580237770903,0.985227802938168,90.73730387447966
2022-10-21,15615,1417614,1438880,5651,0,751,26,-4,773,22,0.010852190592683199,0.9852204492382964,90.78539865513929
2022-10-22,15617,1418276,1439544,5651,2,662,-26,26,664,0,0.01084857427074129,0.9852258770832986,90.81616187487994
2022-10-23,15619,1418791,1440187,5777,2,515,126,0,643,126,0.010845119418519957,0.9851435959358056,90.83750560215123
2022-10-24,15620,1419376,1440812,5816,1,585,25,14,625,39,0.010841109041290606,0.985122278270864,90.86914212548015
2022-10-25,15623,1419880,1441701,6198,3,504,377,5,889,382,0.010836504934102147,0.9848644066973665,90.88395314600268
2022-10-26,15626,1420354,1442767,6787,3,474,562,27,1066,589,0.010830577633117474,0.9844652670874784,90.89683860232945
2022-10-27,15628,1421266,1443829,6935,2,912,112,36,1062,148,0.01082399647049616,0.9843728031505116,90.9435628359355
2022-10-28,15628,1421980,1444836,7228,0,714,254,39,1007,293,0.010816452524715608,0.9841809035765997,90.98925006398771
2022-10-29,15631,1422831,1445877,7415,3,851,187,0,1041,187,0.01081073977938649,0.9840608848470513,91.02622992770776
2022-10-30,15633,1423547,1446958,7778,2,716,357,6,1081,363,0.010804045452597794,0.9838205393660355,91.06038508283758
2022-10-31,15634,1424109,1447780,8037,1,562,268,-9,822,259,0.010798601997541063,0.9836501402146735,91.09050786746833
2022-11-01,15636,1424803,1449339,8900,2,694,834,29,1559,863,0.01078836628283652,0.9830709033566336,91.12324123816833
2022-11-02,15639,1425428,1451120,10053,3,625,1106,47,1781,1153,0.010777192789018137,0.9822950548541816,91.1457254300147
2022-11-03,15642,1426549,1452943,10752,3,1121,628,71,1823,699,0.010765735476202439,0.9818341118681188,91.19991049737885
2022-11-04,15646,1427561,1454979,11772,4,1012,1020,0,2036,1020,0.010753419808808238,0.9811557417667196,91.24127572542503
2022-11-05,15649,1428603,1456838,12586,3,1042,770,44,1859,814,0.010741757148015084,0.9806189844032075,91.29036999169276
2022-11-06,15653,1429670,1458380,13057,4,1067,430,41,1542,471,0.010733142253733594,0.9803137728164127,91.33520730850316
2022-11-07,15657,1430753,1459725,13315,4,1083,261,-3,1345,258,0.010725992909623387,0.9801524259706451,91.3810436226608
2022-11-08,15660,1431618,1461979,14701,3,865,1345,41,2254,1386,0.010711508168037981,0.9792329438384546,91.41877394636015
2022-11-09,15664,1432536,1464536,16336,4,918,1635,0,2557,1635,0.010695537699312275,0.9781500762016092,91.45403472931562
2022-11-10,15666,1434483,1466932,16783,2,1947,331,116,2396,447,0.01067943163009601,0.9778796835845152,91.56664113366526
2022-11-11,15671,1436280,1469515,17564,5,1797,746,35,2583,781,0.010664062632909498,0.9773836946203339,91.6520962287027
2022-11-12,15677,1438276,1472026,18073,6,1996,432,77,2511,509,0.010649947759074907,0.9770724158404811,91.74433884033935
2022-11-13,15685,1440197,1474287,18405,8,1921,329,3,2261,332,0.010639041109363374,0.9768769581499396,91.82001912655403
2022-11-14,15693,1442034,1476058,18331,8,1837,-104,30,1771,-74,0.010631696044464378,0.9769494152668797,91.89026954693175
2022-11-15,15697,1443377,1478990,19916,4,1343,1521,64,2932,1585,0.010613323957565635,0.9759207296871514,91.95241128878129
2022-11-16,15703,1444781,1482658,22174,6,1404,2252,6,3668,2258,0.01059111406676388,0.9744533129015592,92.00668662039101
2022-11-17,15708,1447368,1486132,23056,5,2587,841,41,3474,882,0.010569720590095632,0.9739161797202402,92.14209320091673
2022-11-18,15715,1450159,1488930,23056,7,2791,6,-6,2798,0,0.01055455931440699,0.9739604951206571,92.27865097041044
2022-11-19,15720,1452614,1491558,23224,5,2455,142,26,2628,168,0.010539315266318842,0.9738903884394706,92.40547073791349
2022-11-20,15727,1455008,1493931,23196,7,2394,-26,-2,2373,-28,0.010527259960466715,0.973945918519664,92.51656387104978
2022-11-21,15736,1457416,1495720,22568,9,2408,-620,-8,1789,-628,0.010520685689834997,0.9743909287834621,92.61667513980682
2022-11-22,15750,1459200,1498564,23614,14,1784,1009,37,2844,1046,0.010510061632336023,0.9737321862796651,92.64761904761905
2022-11-23,15757,1460904,1501582,24921,7,1704,1299,8,3018,1307,0.010493599417148048,0.9729099043542078,92.71460303357237
2022-11-24,15766,1464960,1504600,23874,9,4056,-1066,19,3018,-1047,0.010478532500332314,0.9736541273428153,92.91893949004186
2022-11-25,15770,1468483,1507150,22897,4,3523,-999,22,2550,-977,0.010463457519158677,0.9743442922071459,93.11876981610654
2022-11-26,15775,1471963,1509385,21647,5,3480,-1256,6,2235,-1250,0.0104512765132819,0.9752071207809804,93.30985736925516
2022-11-27,15782,1474496,1511229,20951,7,2533,-651,-45,1844,-696,0.01044315586850173,0.9756932933393946,93.4289697123305
2022-11-28,15789,1477170,1512525,19566,7,2674,-1377,-8,1296,-1385,0.010438835721723608,0.976625179749095,93.55690670720122
2022-11-29,15795,1478983,1514545,19767,6,1813,244,-43,2020,201,0.010428874678533817,0.9765196808282356,93.63615068059512
2022-11-30,15801,1480792,1516900,20307,6,1809,566,-26,2355,540,0.010416639198365087,0.9761961895972048,93.71508132396684
2022-12-01,15810,1484243,1518857,18804,9,3451,-1445,-58,1957,-1503,0.010409143191228667,0.977210494470513,93.88001265022137
2022-12-02,15817,1486667,1520501,18017,7,2424,-753,-34,1644,-787,0.01040249233640754,0.9777481238091918,93.99171777201745
2022-12-03,15818,1489541,1521942,16583,1,2874,-1425,-9,1441,-1434,0.010393300138901482,0.9787107524465453,94.1674674421545
2022-12-04,15822,1492385,1522998,14791,4,2844,-1750,-42,1056,-1792,0.010388720142771035,0.9798995139849166,94.32341044115788
2022-12-05,15830,1494565,1523802,13407,8,2180,-1382,-2,804,-1384,0.010388488793163416,0.9808131240147998,94.41345546430827
2022-12-06,15834,1495989,1525050,13227,4,1424,-157,-23,1248,-180,0.01038261040621619,0.9809442313366775,94.47953770367563
2022-12-07,15838,1497279,1526330,13213,4,1290,31,-45,1280,-14,0.01037652408063787,0.9809667634128924,94.53712589973482
2022-12-08,15840,1499798,1527368,11730,2,2519,-1386,-97,1038,-1483,0.01037078163219342,0.9819493403030572,94.68421717171717
2022-12-09,15848,1501566,1528186,10772,8,1768,-947,-11,818,-958,0.010370465375288086,0.9825806544491312,94.7479808177688
2022-12-10,15849,1503634,1528941,9458,1,2068,-1230,-84,755,-1314,0.010365998426361775,0.9834480205580203,94.87248406839548
2022-12-11,15854,1505189,1529544,8501,5,1555,-895,-62,603,-957,0.010365180733604264,0.9840769536541609,94.94064589378075
2022-12-12,15856,1506506,1529982,7620,2,1317,-891,10,438,-881,0.010363520616582418,0.9846560286330166,95.01173057517659
2022-12-13,15860,1507394,1530568,7314,4,888,-266,-40,586,-306,0.010362166202351022,0.9848592156637275,95.0437578814628
2022-12-14,15865,1508273,1531274,7136,5,879,-103,-75,706,-178,0.01036065393913826,0.9849791742039635,95.06920895052001
2022-12-15,15867,1509640,1531847,6340,2,1367,-728,-68,573,-796,0.010358084064531248,0.985503121395283,95.14337934077015
2022-12-16,15874,1510813,1532332,5645,7,1173,-691,-4,485,-695,0.010359373817162338,0.9859566986788764,95.17531813027593
2022-12-17,15879,1511764,1532726,5083,5,951,-527,-35,394,-562,0.010359973015398708,0.986323713436061,95.2052396246615
2022-12-18,15881,1512563,1533019,4575,2,799,-484,-24,293,-508,0.010359297569045132,0.9866563949957567,95.24356148857125
2022-12-19,15883,1513231,1533303,4189,2,668,-375,-11,284,-386,0.01035868318264557,0.9869093062493193,95.27362588931562
2022-12-20,15886,1513767,1533620,3967,3,536,-197,-25,317,-222,0.010358498193815938,0.9870548114917645,95.28937429182929
2022-12-21,15890,1514226,1533999,3883,4,459,-54,-30,379,-84,0.010358546517957312,0.9871101610887622,95.2942731277533
2022-12-22,15893,1515024,1534302,3385,3,798,-479,-19,303,-498,0.010358456157914153,0.9874353288987435,95.32649594160951
2022-12-23,15895,1515641,1534582,3046,2,617,-307,-32,280,-339,0.010357869439365248,0.9876572252248496,95.35331865366467
2022-12-24,15898,1516168,1534836,2770,3,527,-275,-1,254,-276,0.010358109921841812,0.9878371369970472,95.36847402188954
2022-12-25,15900,1516573,1535048,2575,2,405,-195,0,212,-195,0.01035798229110751,0.9879645457340748,95.3819496855346
2022-12-26,15901,1516949,1535185,2335,1,376,-209,-31,137,-240,0.010357709331448653,0.9881213013415321,95.39959750959059
2022-12-27,15901,1517259,1535370,2210,0,310,-106,-19,185,-125,0.010356461309000437,0.9882041462318529,95.4190931387963
2022-12-28,15903,1517512,1535600,2185,2,253,-7,-18,230,-25,0.010356212555352956,0.988220890856994,95.42300194931774
2022-12-29,15904,1517906,1535789,1979,1,394,-209,3,189,-206,0.010355589211799278,0.9883558223167376,95.44177565392354
2022-12-30,15906,1518186,1535970,1878,2,280,-80,-21,181,-101,0.010355671009199399,0.9884216488603293,95.44737834779329
2022-12-31,15909,1518494,1536126,1723,3,308,-151,-4,156,-155,0.010356572312427497,0.9885217749064855,95.44873970708404
2023-01-01,15911,1518805,1536256,1540,2,311,-183,0,130,-183,0.010356997792034662,0.9886405651141477,95.45628810257055
2023-01-02,15913,1519020,1536325,1392,2,215,-125,-23,69,-148,0.010357834442582136,0.9887361072689698,95.45780179727267
2023-01-03,15914,1519229,1536517,1374,1,209,-6,-12,192,-18,0.010357190971528464,0.9887485787661314,95.46493653386955
2023-01-04,15915,1519353,1536727,1459,1,124,110,-25,210,85,0.010356426352891567,0.9886941532230513,95.46672950047126
2023-01-05,15916,1519553,1536910,1441,1,200,-10,-8,183,-18,0.010355843868541425,0.9887065605663311,95.47329731088213
2023-01-06,15918,1519752,1537098,1428,2,199,-14,1,188,-13,0.01035587841503925,0.9887150981915271,95.47380324161327
2023-01-07,15920,1519945,1537249,1384,2,193,-38,-6,151,-44,0.010356162209245217,0.9887435282117601,95.47393216080403
2023-01-08,15921,1520133,1537374,1320,1,188,-64,0,125,-64,0.010355970635642335,0.9887854224151053,95.47974373469003
2023-01-09,15924,1520284,1537455,1267,3,151,-66,-7,81,-53,0.010357376313453077,0.988831543037032,95.471238382316
2023-01-10,15925,1520387,1537579,1267,1,103,13,7,124,0,0.010357191402848244,0.9888187858965295,95.47171114599686
2023-01-11,15926,1520477,1537725,1322,1,90,55,0,146,55,0.010356858345933116,0.9887834300671446,95.47136757503453
2023-01-12,15926,1520713,1537884,1245,0,236,-44,-33,159,-77,0.01035578756265102,0.9888346585308124,95.48618611076228
2023-01-13,15928,1520897,1538004,1179,2,184,-80,14,120,-66,0.010356279957659408,0.9888771420620492,95.48574836765445
2023-01-14,15928,1521132,1538176,1116,0,235,-56,-7,172,-63,0.010355121910626612,0.9889193434301407,95.50050226017076
2023-01-15,15929,1521280,1538260,1051,1,148,-75,10,84,-65,0.010355206532055699,0.9889615539635692,95.50379810408688
2023-01-16,15929,1521435,1538330,966,0,155,-85,0,70,-85,0.010354735329870704,0.9890173109800888,95.51352878397891
2023-01-17,15929,1521629,1538441,883,0,194,-88,5,111,-83,0.010353988225742813,0.9890720541119224,95.52570782848892
2023-01-18,15931,1521707,1538559,921,2,78,59,-21,118,38,0.010354494042802389,0.9890468938792727,95.51861151214614
2023-01-19,15934,1521791,1538643,918,3,84,-4,1,84,-3,0.010355878524128078,0.9890474918483365,95.50589933475587
2023-01-20,15936,1521917,1538735,882,2,126,-34,-2,92,-36,0.010356559121616133,0.9890702427643486,95.50181977911646
2023-01-21,15937,1522083,1538816,796,1,166,-87,1,81,-86,0.0103566638246548,0.9891260553568458,95.50624333312417
2023-01-22,15939,1522186,1538900,775,2,103,-6,-15,84,-21,0.010357398141529663,0.9891389953863149,95.5007215007215
2023-01-23,15939,1522288,1538945,718,0,102,-57,0,45,-57,0.010357095282807378,0.9891763513315941,95.50712089842524
2023-01-24,15940,1522374,1539007,693,1,86,-14,-11,62,-25,0.010357327809425169,0.9891923818410183,95.5065244667503
2023-01-25,15941,1522427,1539094,726,1,53,34,-1,87,33,0.010357392076117508,0.9891709018422526,95.50385797628756
2023-01-26,15941,1522544,1539191,706,0,117,-14,-6,97,-20,0.010356739352036232,0.9891845781322786,95.51119754093219
2023-01-27,15941,1522655,1539255,659,0,111,-47,0,64,-47,0.010356308733770558,0.9892155620738604,95.51816071764632
2023-01-28,15941,1522740,1539325,644,0,85,-8,-7,70,-15,0.010355837786042583,0.9892257970214218,95.52349287999498
2023-01-29,15942,1522817,1539388,629,1,77,-10,-5,63,-15,0.01035606357851302,0.9892353324827788,95.52233094969263
2023-01-30,15942,1522903,1539456,611,0,86,-8,-10,68,-18,0.010355606136193565,0.9892475004157313,95.52772550495547
2023-01-31,15942,1522973,1539553,638,0,70,20,7,97,27,0.010354953678113062,0.9892306403222234,95.53211642202986
2023-02-01,15942,1523015,1539633,676,0,42,22,16,80,38,0.010354415630218371,0.9892065186963387,95.5347509722745
2023-02-02,15942,1523068,1539734,724,0,53,64,-16,101,48,0.01035373642460321,0.989176052486988,95.53807552377368
2023-02-03,15944,1523178,1539796,674,2,110,-55,5,62,-50,0.010354618403996374,0.9892076612746104,95.53299046663322
2023-02-04,15946,1523262,1539857,649,2,84,-17,-8,61,-25,0.010355507037341779,0.9892230252549425,95.52627618211464
2023-02-05,15946,1523334,1539908,628,0,72,-19,-2,51,-21,0.010355164074736932,0.989237019354403,95.53079142104603
2023-02-06,15947,1523440,1539977,590,1,106,-41,3,69,-38,0.01035534946301146,0.9892615279319107,95.5314479212391
2023-02-07,15948,1523491,1540177,738,1,51,148,0,200,148,0.010354654043009342,0.9891661802507115,95.5286556308001
2023-02-08,15949,1523556,1540267,762,1,65,23,1,90,24,0.0103546982438759,0.9891505823341018,95.52674148849458
2023-02-09,15949,1523659,1540355,747,0,103,-1,-14,88,-15,0.010354106683199651,0.9891609401728823,95.53319957364099
2023-02-10,15950,1523757,1540459,752,1,98,12,-7,104,5,0.010354056810340295,0.9891577770002318,95.53335423197493
2023-02-11,15951,1523850,1540551,750,1,93,-2,0,92,-2,0.010354087595931585,0.9891590736041844,95.53319541094602
2023-02-12,15952,1523936,1540627,739,1,86,-10,-1,76,-11,0.010354225909321335,0.9891660992569908,95.53259779338013
2023-02-13,15952,1524010,1540700,738,0,74,-5,4,73,-1,0.010353735315116505,0.9891672616343221,95.53723671013039
2023-02-14,15954,1524096,1540789,739,2,86,2,-1,89,1,0.010354435292567639,0.9891659403072063,95.53065062053403
2023-02-15,15955,1524158,1540890,777,1,62,36,2,101,38,0.010354405570806482,0.9891413403941878,95.52854904418678
2023-02-16,15955,1524271,1540999,773,0,113,-4,0,109,-4,0.010353673169158448,0.9891447041821572,95.53563146349107
2023-02-17,15957,1524333,1541112,822,2,62,49,0,113,49,0.010354211763973028,0.9891124071449706,95.52754277119759
2023-02-18,15957,1524433,1541199,809,0,100,-13,0,87,-13,0.010353627273311234,0.9891214567359569,95.53380961333583
2023-02-19,15958,1524529,1541258,771,1,96,-38,0,59,-38,0.010353879752773383,0.9891458795347696,95.53383882692067
2023-02-20,15958,1524625,1541306,723,0,96,-48,0,48,-48,0.010353557307893436,0.9891773599791346,95.53985461837323
2023-02-21,15960,1524774,1541403,669,2,149,-47,-7,97,-54,0.010354203281036822,0.989211776543837,95.53721804511278
2023-02-22,15960,1524774,1541495,761,0,0,72,20,92,92,0.01035358531814894,0.9891527380886737,95.53721804511278
2023-02-23,15961,1524888,1541569,720,1,114,-42,1,74,-41,0.01035373700431184,0.9891792063799933,95.53837478854709
2023-02-24,15962,1524989,1541666,715,1,101,-2,-3,97,-5,0.010353734207020198,0.9891824818086408,95.53871695276281
2023-02-25,15963,1525083,1541744,698,1,94,-1,-16,78,-17,0.010353859006423894,0.989193406946938,95.5386205600451
2023-02-26,15963,1525184,1541820,673,0,101,-25,0,76,-25,0.010353348639919057,0.9892101542333087,95.54494769153668
2023-02-27,15963,1525260,1541869,646,0,76,-22,-5,49,-27,0.01035301961450681,0.9892280083457154,95.54970870137193
2023-02-28,15963,1525330,1541970,677,0,70,26,5,101,31,0.010352341485242904,0.9892086097654299,95.55409384200965
2023-03-01,15964,1525387,1542064,713,1,57,41,-5,94,36,0.010352358916361448,0.9891852737629566,95.55167877724881
2023-03-02,15964,1525473,1542170,733,0,86,15,5,106,20,0.010351647354053055,0.9891730483669116,95.5570658982711
2023-03-03,15964,1525556,1542265,745,0,83,13,-1,95,12,0.010351009716229053,0.989165934518387,95.56226509646704
2023-03-04,15964,1525658,1542365,743,0,102,-2,0,100,-2,0.010350338603378577,0.9891679336603203,95.56865447256327
2023-03-05,15964,1525751,1542443,728,0,93,-15,0,78,-15,0.010349815195764122,0.9891782062611065,95.57448008018041
2023-03-06,15964,1525812,1542496,720,0,61,-12,4,53,-8,0.010349459577204739,0.9891837644959858,95.5783011776497
2023-03-07,15964,1525880,1542623,779,0,68,52,7,127,59,0.01034860753405077,0.9891464084225374,95.58256076171385
2023-03-08,15965,1525930,1542775,880,1,50,95,6,152,101,0.010348236132942263,0.9890813631281296,95.57970560601315
2023-03-09,15966,1526038,1542917,913,1,108,28,5,142,33,0.010347931871902378,0.9890603318260153,95.58048352749593
2023-03-10,15966,1526138,1543071,967,0,100,55,-1,154,54,0.01034689913814724,0.9890264284663506,95.58674683702868
2023-03-11,15966,1526249,1543195,980,0,111,10,3,124,13,0.010346067736092975,0.9890188861420625,95.59369911061005
2023-03-12,15967,1526350,1543310,993,1,101,13,0,115,13,0.01034594475510429,0.9890106329901316,95.59403770276195
2023-03-13,15967,1526428,1543422,1027,0,78,29,5,112,34,0.010345193991014771,0.9889894014728311,95.5989227782301
2023-03-14,15968,1526501,1543557,1088,1,73,60,1,135,61,0.010344937051239442,0.9889501974983755,95.59750751503006
2023-03-15,15969,1526566,1543722,1187,1,65,96,3,165,99,0.010344479122536311,0.9888866000484543,95.59559145845076
2023-03-16,15970,1526700,1543896,1226,1,134,45,-6,174,39,0.010343960992191184,0.9888619440687715,95.59799624295555
2023-03-17,15972,1526854,1544048,1222,2,154,-23,19,152,-4,0.010344238002963638,0.9888643358237568,95.59566741798147
2023-03-18,15973,1527032,1544205,1200,1,178,-38,16,157,-22,0.010343833882159429,0.9888790672222924,95.60082639454079
2023-03-19,15973,1527158,1544333,1202,0,126,2,0,128,2,0.010342976547156605,0.9888786939086324,95.6087147060665
2023-03-20,15974,1527286,1544433,1173,1,128,-33,4,100,-29,0.010342954339877482,0.9888975436292802,95.6107424564918
2023-03-21,15974,1527390,1544635,1271,0,104,99,-1,202,98,0.010341601737627337,0.988835550146151,95.6172530361838
2023-03-22,15975,1527482,1544859,1402,1,92,134,-3,224,131,0.010340749544133153,0.9887517242673927,95.61702660406885
2023-03-23,15975,1527670,1545009,1364,0,188,-31,-7,150,-38,0.010339745593714988,0.9887774116526182,95.62879499217527
2023-03-24,15975,1527826,1545154,1353,0,156,-11,0,145,-11,0.010338775293595332,0.9887855838317734,95.63856025039124
2023-03-25,15977,1527956,1545327,1394,2,130,40,1,173,41,0.01033891208786231,0.9887590134644642,95.63472491706828
2023-03-26,15977,1528117,1545532,1438,0,161,44,0,205,44,0.010337540730311633,0.9887320353121126,95.64480190273518
2023-03-27,15977,1528299,1545669,1393,0,182,-45,0,137,-45,0.010336624464875727,0.9887621476525699,95.65619327783689
2023-03-28,15978,1528397,1545903,1528,1,98,123,12,234,135,0.010335706703460696,0.9886758742301425,95.65633996745525
2023-03-29,15978,1528500,1546143,1665,0,103,149,-12,240,137,0.010334102343703008,0.9885890244304699,95.66278633120541
2023-03-30,15978,1528772,1546383,1633,0,272,-53,21,240,-32,0.010332498481941408,0.9886114888743603,95.67980973839029
2023-03-31,15981,1528900,1546579,1698,3,128,70,-5,196,65,0.01033312879587787,0.9885689641460281,95.66985795632313
2023-04-01,15982,1529197,1546798,1619,1,297,-72,-7,219,-79,0.010332312299343548,0.9886210093367072,95.68245526216994
2023-04-02,15982,1529197,1547000,1821,0,0,182,20,202,202,0.010330963154492567,0.9884919198448611,95.68245526216994
2023-04-03,15982,1529380,1547136,1774,0,183,-36,-11,136,-47,0.010330055017787707,0.988523310167949,95.69390564384933
2023-04-04,15984,1529543,1547371,1844,2,163,63,7,235,70,0.01032977870206951,0.9884785226038229,95.69212962962963
2023-04-05,15985,1529673,1547651,1993,1,130,128,21,280,149,0.010328555985813339,0.9883836859860524,95.69427588364091
2023-04-06,15986,1529868,1547929,2075,1,195,92,-10,278,82,0.010327347055323597,0.9883321521852746,95.70048792693606
2023-04-07,15987,1530107,1548224,2130,1,239,38,17,295,55,0.01032602517465173,0.9882982049109172,95.70945142928629
2023-04-08,15988,1530341,1548414,2085,1,234,-30,-15,190,-45,0.01032540392944006,0.9883280569666769,95.71810107580686
2023-04-09,15988,1530593,1548619,2038,0,252,-57,10,205,-47,0.010324037093694446,0.9883599516730713,95.73386289717288
2023-04-10,15988,1530909,1548841,1944,0,316,-94,0,222,-94,0.010322557318666022,0.9884223106180686,95.75362772079059
2023-04-11,15992,1531074,1549214,2148,4,165,187,17,373,204,0.010322653939352472,0.9882908365145164,95.73999499749875
2023-04-12,15996,1531162,1549689,2531,4,88,361,22,475,383,0.010322071073615416,0.9880446980006956,95.72155538884721
2023-04-13,16000,1531554,1550130,2576,4,392,38,7,441,45,0.010321714952939431,0.9880164889396373,95.722125
2023-04-14,16004,1531835,1550616,2777,4,281,192,9,486,201,0.010321059501514237,0.9878880393340453,95.71575856035992
2023-04-15,16006,1532062,1551011,2943,2,227,166,0,395,166,0.010319720491988774,0.9877828074720295,95.71798075721604
2023-04-16,16006,1532303,1551423,3114,0,241,170,1,412,171,0.01031697995968862,0.9876758305117302,95.73303761089592
2023-04-17,16009,1532483,1551717,3225,3,180,110,1,294,111,0.01031695856912053,0.9876046985371688,95.72634143294397
2023-04-18,16017,1532321,1552260,3922,8,-162,648,49,543,697,0.01031850334351204,0.9871548580778993,95.66841480926516
2023-04-19,16017,1532844,1552783,3922,0,523,0,0,523,0,0.01031502792083633,0.9871591845093616,95.70106761565836
2023-04-20,16017,1533354,1553293,3922,0,510,0,0,510,0,0.010311641139179794,0.9871634005947365,95.73290878441655
2023-04-21,16017,1533856,1553677,3804,0,502,-118,0,384,-118,0.010309092559135521,0.9872425220943607,95.76425048386089
2023-04-22,16018,1534128,1553954,3808,1,272,16,-12,277,4,0.010307898431999918,0.9872415785795461,95.77525284055437
2023-04-23,16018,1534806,1554085,3261,0,678,-547,0,131,-547,0.010307029538281368,0.9875946296373751,95.81758022224997
2023-04-24,16019,1535143,1554274,3112,1,337,-149,0,189,-149,0.010306419588824106,0.9876913594385546,95.8326362444597
2023-04-25,16019,1535535,1554671,3117,0,392,5,0,397,5,0.010303787746732266,0.9876912864522461,95.85710718521756
2023-04-26,16023,1535844,1555034,3167,4,309,50,0,363,50,0.010303954768834637,0.9876594338130228,95.85246208575172
2023-04-27,16027,1536382,1555577,3168,4,538,-78,79,543,1,0.010302929395330479,0.9876605272513029,95.86210769326762
2023-04-28,16033,1537020,1556233,3180,6,638,6,6,656,12,0.010302441857999412,0.9876541623265925,95.86602632071353
2023-04-29,16034,1537356,1556937,3547,1,336,354,13,704,367,0.010298425690956025,0.9874233832197449,95.88100286890358
2023-04-30,16034,1537756,1557567,3777,0,400,230,0,630,230,0.010294260214809378,0.9872808039718356,95.90594985655483
2023-05-01,16037,1538012,1557835,3786,3,256,5,4,268,9,0.010294415005440243,0.9872752891031463,95.90397206460061
2023-05-02,16040,1538160,1558247,4047,3,148,243,18,412,261,0.010293618405811146,0.9871092323617501,95.89526184538653
2023-05-03,16041,1538449,1559058,4568,1,289,509,12,811,521,0.010288905223538829,0.9867811203944946,95.90730004363817
2023-05-04,16043,1538846,1559843,4954,2,397,396,-10,785,386,0.010285009452874423,0.9865390298895466,95.9200897587733
2023-05-05,16046,1539214,1560540,5280,3,368,318,8,697,326,0.010282338164994168,0.9863342176426109,95.92509036520005
2023-05-06,16050,1539874,1561126,5202,4,660,-66,-12,586,-78,0.010281040735981593,0.986386749051646,95.94230529595015
2023-05-07,16053,1540404,1561594,5137,3,530,-53,-12,468,-65,0.01027988068601698,0.986430531879605,95.95739114184265
2023-05-08,16054,1541192,1561929,4683,1,788,-445,-9,335,-454,0.010278316107838449,0.9867234682242279,96.00049831817616
2023-05-09,16060,1541361,1562435,5014,6,169,335,-4,506,331,0.010278827599228128,0.9865120789024824,95.97515566625155
2023-05-10,16060,1541979,1563053,5014,0,618,0,0,618,0,0.010274763555682373,0.9865174117576307,96.01363636363637
2023-05-11,16065,1542446,1563536,5025,5,467,40,-29,483,11,0.010274787404959016,0.9865113435187933,96.01282290694056
2023-05-12,16068,1543196,1564006,4742,3,750,-266,-17,470,-283,0.010273617876146255,0.986694424445942,96.04157331341797
2023-05-13,16074,1544099,1564410,4237,6,903,-494,-11,404,-505,0.010274800084376859,0.9870168306262425,96.06190120691801
2023-05-14,16076,1544767,1564727,3884,2,668,-332,-21,317,-353,0.01027399667801476,0.9872437811835547,96.09150286140832
2023-05-15,16080,1545339,1564960,3541,4,572,-327,-16,233,-343,0.010275023003782845,0.9874622993558941,96.10317164179105
2023-05-16,16082,1545690,1565091,3319,2,351,-219,-3,131,-222,0.010275440852959988,0.9876039156828581,96.11304564108941
2023-05-17,16082,1546668,1565362,2612,0,978,-670,-37,271,-707,0.010273661938899756,0.9880577144456043,96.17385897276458
2023-05-18,16082,1546668,1565545,2795,0,0,126,57,183,183,0.010272461027948734,0.9879422182051618,96.17385897276458
2023-05-21,16088,1548022,1565953,1843,0,120,0,0,120,0,0.010273616130241458,0.9885494647668225,96.22215315763302
2023-05-22,16090,1548472,1566034,1472,2,450,-371,0,81,-371,0.010274361859321061,0.98878568409115,96.23816034804226
